form	lemma	POS	morph
communia	communis
voluit	uolo3
commoda	commodum1
profanis	profanus
incommoda	incommodum
pari	par2
consortio	consortio
lenitatem	lenitas
severitatem	seueritas
experiremur	experior
didicimus	disco
diligimus	diligo3
lenitatem	lenitas
metuimus	metuo
severitatem	seueritas
utramque	uterque
despicitis	despicio
sequitur	sequor
saeculi	saeculum
plagae	plaga1
admonitionem	admonitio
castigationem	castigatio
deo	deus
obveniant	obuenio
atquin	atqui
laedimur	laedo
inprimis	imprimis
refert	refero
aevo	aeuum
celeriter	celeriter
excedere	excedo1
dehinc	dehinc
adversi	aduersum
infligitur	infligo
meritis	meritum
deputatur	deputo
praestringunt	praestringo
cohaerentes	cohaereo
laetamur	laetor
recognitione	recognitio
divinarum	diuinus2
praedicationem	praedicatio
confirmantium	confirmo
fiduciam	fiducia
fidem	fides2
spei	spes
colitis	colo2
mala	malum1
eveniunt	euenio
colere	colo2
perseverans	perseuero
ingratos	ingratus
iniustos	iniustus
dolore	dolor
christianorum	christianus1
iuvare	iuuo
adserere	assero2
debuerant	debeo
iniuriarum	iniuria
titulo	titulus
postulantur	postulo
infructuosi	infructuosus
negotiis	negotium
pacto	pactum
homines	homo
degentes	dego
victus	uictus
instructus	instruo
vitam	uita
necessitatis	necessitas
brachmanae	brachmanus
indorum	indor
gymnosophistae	gymnosophistes
silvicolae	siluicola
exules	exsul
vitae	uita
meminimus	memini
gratiam	gratia
debere	debeo
deo	deus
domino	dominus
creatori	creator
fructum	fructus
operum	opus1
repudiamus	repudio
temperamus	tempero
modum	modus
perperam	perperam
utamur	utor
foro	forum1
macello	macellum
balneis	balineae
tabernis	taberna
officinis	officina
stabulis	stabulum
nundinis	nundinae
commerciis	commercium
cohabitamus	cohabito
saeculo	saeculum
navigamus	nauigo
militamus	milito2
rusticamur	rusticor
mercamur	mercor
miscemus	misceo
artes	ars
operas	opera
publicamus	publico
usui	usus
infructuosi	infructuosus
negotiis	negotium
vivimus	uiuo
scio	scio
caerimonias	caerimonia
frequento	frequens
attamen	attamen
die	dies
homo	homo
lavor	lauo1
diluculo	diluculum
saturnalibus	saturnalia
noctem	nox
diem	dies
perdam	perdo
attamen	attamen
lavor	lauo1
honesta	honestus
hora	hora
salubri	saluber
calorem	calor
sanguinem	sanguis
servet	seruo
rigere	rigeo
pallere	palleo
lavacrum	lauacrum
mortuus	mortuus?
publico	publicus2
liberalibus	liberalis
discumbo	discumbo
bestiariis	bestiarius1
supremam	superus
coenantibus	coeno
mos	mos
attamen	attamen
ubiubi	ubiubi
copiis	copia
coeno	coenum
emo	emo
capiti	caput
coronam	corona
interest	intersum1
emptis	emo
nihilominus	nihilominus
floribus	flos
utar	utor
puto	puto
gratius	gratus
liberis	liberi
solutis	solutus
vagis	uagus
coronam	corona
coactis	cogo
coronam	corona
naribus	naris
novimus	nosco
capillum	capillus
odorantur	odoror
spectaculis	spectaculum
convenimus	conuenio
coetus	coetus
venditantur	uendito
desideravero	desidero
liberius	libere
propriis	proprius
locis	locus
sumam	sumo
thura	thura
emimus	emo
arabiae	arabia
queruntur	queror
sciant	scio
sabaei	sabaeum
carioris	carus
merces	merces
christianis	christianus1
sepeliendis	sepelio
profligari	profligo
deis	deus
fumigandis	fumigo
inquitis	inquies2
templorum	templum
vectigalia	uectigal
cotidie	cotidie
decoquunt	decoquo
stipes	stips
quotusquisque	quotusquisque
iactat	iacto
sufficimus	sufficio
hominibus	homo
deis	deus
mendicantibus	mendico
opem	ops
putamus	puto
petentibus	peto
inpertiendum	impertio
porrigat	porrigo2
manum	manus1
iupiter	iupiter
accipiat	accipio
misericordia	misericordia
insumit	insumo
vicatim	uicatim
religio	religio
templatim	templatim
vectigalia	uectigal
gratias	gratia
christianis	christianus1
agent	ago
fide	fides2
dependentibus	dependeo
debitum	debitum
alieno	alienus2
fraudando	fraudo
abstinemus	abstineo
ineatur	ineo1
vectigalibus	uectigal
pereat	pereo1
fraude	fraus
mendacio	mendacium
professionum	professio
facile	facile
ratio	ratio
unius	unus
speciei	species
querela	querela
conpensata	compenso
commodo	commodum1
rationum	ratio
confitebor	confiteor
vere	uere
sterilitate	sterilitas
christianorum	christianus1
conqueri	conqueror
primi	primus
lenones	leno1
perductores	perductor
aquarioli	aquariolum
sicarii	sicarius
venenarii	uenenaris
magi	magis2
aruspices	aruspex
arioli	ariolus
mathematici	mathematicus1
infructuosos	infructuosus
magnus	magnus
fructus	fructus
dispendium	dispendium
sectam	seco
praesidio	praesidium
conpensari	compenso
daemonia	daemonium
excutiant	excutio
deo	deus
preces	prex
sternant	sterno
creditis	credo
timere	timeo
detrimentum	detrimentum
reipublicae	respublica
grande	grandis
verum	uerum4
circumspicit	circumspicio
iniuriam	iniuria
civitatis	ciuitas
expendit	expendo
iusti	iustus
impendimur	impendo
innocentes	innocens
erogamur	erogo
contestamur	contestor
actus	ago
cotidie	cotidie
iudicandis	iudico
custodiis	custodia
praesidetis	praesideo
sententiis	sententia
elogia	elogium
dispungitis	dispungo
nocentes	nocens
variis	uarius
criminum	crimen
elogiis	elogium
recensentur	recenseo
sicarius	sicarius
manticularius	manticularius
sacrilegus	sacrilegus1
corruptor	corruptor
lavantium	lauo1
praedo	praedo
christianus	christianus1
adscribitur	ascribo
christiani	christianus1
titulo	titulus
offeruntur	offero
nocentes	nocens
aestuat	aestuo
carcer	carcer
metalla	metallum
suspirant	suspiro
bestiae	bestia
saginantur	sagino
munerarii	munerarius
noxiorum	noxius
greges	grex
pascunt	pasco
christianus	christianus1
christianus	christianus1
christianus	christianus1
soli	solus
innocentes	innocens
mirum	mirus
necesse	necesse
enimvero	enimuero
necesse	necesse
innocentiam	innocentia
deo	deus
edocti	edoceo
perfecte	perfecte
novimus	nosco
perfecto	perficio
magistro	magister
revelatam	reuelo
fideliter	fideliter
custodimus	custodio
incontemptibili	incontemptibilis
dispectore	dispector
mandatam	mando2
humana	humanus
aestimatio	aestimatio
innocentiam	innocentia
tradidit	trado
humana	humanus
dominatio	dominatio
imperavit	impero
plenae	plenus
timcndae	tincndus
disciplinae	disciplina
innocentiae	innocentia
veritatem	ueritas
prudentia	prudentia
hominis	homo
demonstrandum	demonstro
bonum	bonum
auctoritas	auctoritas
exigendum	exigo
falli	fallo
facilis	facilis
contemni	contemno
plenius	plene
occides	occido2
docere	doceo
irascaris	irascor
perfectius	perfecte
prohibere	prohibeo
adulterium	adulterium
oculorum	oculus
solitaria	solitarius
concupiscentia	concupisco
arcere	arceo
eruditius	erudite
maleficio	maleficium
maliloquio	maliloquium
interdicere	interdico2
instructius	instructus2
iniuriam	iniuria
permittere	permitto
vicem	uicis
iniuriae	iniuria
sinere	sino
sciatis	scio
leges	lex
innocentiam	innocentia
pergere	pergo
divina	diuinus2
lege	lex
antiquiore	antiquus
forma	forma
mutuatas	mutuor
moysi	moysis
aetate	aetas
auctoritas	auctoritas
legum	lex
humanarum	humanus
evadere	euado2
homini	homo
contingat	contingo1
admissis	admitto
delitiscenti	delitesco
contemnere	contemno
voluntate	uoluntas
necessitate	necessitas
deliquenti	deliquens
recogitate	recogitas
brevitate	breuitas
supplicii	supplicium
mortem	mors
remansuri	remaneo
epicurus	epicurus
cruciatum	cruciatus
doloremque	dolor
{doloremque}	que
depretiat	depretio
modicum	modicus
contemptibilem	contemptibilis
pronuntiando	pronuntio
magnum	magnus
diuturnum	diuturnus
enimvero	enimuero
deo	deus
speculatore	speculator
dispungimur	dispungo
aeternam	aeternus
poenam	poena
providemus	prouideo
merito	merito2
soli	solus
innocentiae	innocentia
occurrimus	occurro
scientiae	scientia
plenitudine	plenitudo
latebrarum	latebra
difficultate	difficultas
magnitudine	magnitudo
cruciatus	cruciatus
diuturni	diuturnus
verum	uerum4
sempiterni	sempiternus
timentes	timeo
timere	timeo
debebit	debeo
timentes	timeo
iudicat	iudico
deum	deus
proconsulem	proconsul
timentes	timeo
constitimus	consto
opinor	opinor
criminum	crimen
intentationem	intentatio
christianorum	christianus1
sanguinem	sanguis
flagitat	flagito
ostendimus	ostendo
totum	totus
statum	status1
modis	modus
probare	probo
ostendimus	ostendo
fide	fides2
antiquitate	antiquitas
divinarum	diuinus2
litterarum	littera
confessione	confessio
spiritualium	spiritualis
potestatum	potestas
revincere	reuinco
audebit	audeo
arte	ars
verborum	uerbum
forma	forma
probationem	probatio
constituimus	constituo
veritate	ueritas
unicuique	unusquisque
manifestatur	manifesto2
veritas	ueritas
incredulitas	incredulitas
bono	bonum
sectae	secta
obducitur	obduco
usui	usus
commercio	commercium
innotuit	innotus
divinum	diuinus2
negotium	negotium
existimat	existimo
philosophiae	philosophia
genus	genus1
philosophi	philosophus1
monent	moneo
profitentur	profiteor
innocentiam	innocentia
iustitiam	iustitia
patientiam	patientia
sobrietatem	sobrietas
pudicitiam	pudicitia
comparamur	comparo3
disciplina	disciplina
adaequamur	adaequo
licentiam	licentia
impunitatemque	impunitas
{impunitatemque}	que
disciplinae	disciplina
pares	par2
urgentur	urgeo
officia	officium
obeuntes	obeo1
periclitamur	periclitor
philosophum	philosophus1
sacrificare	sacrifico
deierare	deiero
lucernas	lucerna
meridie	meridies
vanas	uanus
proferre	profero
conpellit	compello2
quinimmo	quinimmo
deos	deus
palam	palam1
destruunt	destruo
superstitiones	superstitio
commentariis	commentarius1
accusant	accuso
laudantibus	laudo
plerique	plerique
principes	princeps1
latrant	latro2
sustinentibus	sustineo
facilius	facile
statuis	statua
salariis	salarium
remunerantur	remuneror
bestias	bestia
pronuntiantur	pronuntio
merito	merito2
philosophi	philosophus1
christiani	christianus1
cognominantur	cognomino
nomen	nomen
philosophorum	philosophus1
daemonia	daemonium
fugat	fugo
deos	deus
philosophi	philosophus1
daemonas	daemon
deputent	deputo
socratis	socratus
vox	uox
daemonium	daemonium
permittat	permitto
veritate	ueritas
sapiebat	sapio
deos	deus
negans	nego
aesculapio	aesculapium
gallinaceum	gallinaceus
prosecari	proseco
fine	finis
iubebat	iubeo
credo	credo
honorem	honor
patris	pater
socratem	socrates
apollo	apollo
sapientissimum	sapiens2
cecinit	cano
o	o
apollinem	apollo
inconsideratum	inconsideratus
sapientiae	sapientia
testimonium	testimonium
reddidit	reddo
viro	uir
negabat	nego
deos	deus
odium	odium
flagrat	flagro
veritas	ueritas
fide	fides2
praestat	praesto1
offendit	offendo
adulterat	adultero
adfectat	affecto
maxime	magis2
nomine	nomen
gratiam	gratia
pangit	pango
insectatores	insectator
veritatis	ueritas
inlusores	illusor
corruptores	corruptor
inimice	inimicus1
philosophi	philosophus1
adfectant	affecto
veritatem	ueritas
adfectando	affecto
corrumpunt	corrumpo
gloriam	gloria
captant	capto
christiani	christianus1
necessario	necessario
appetunt	appeto
integre	integre
praestant	praesto1
saluti	salus
curant	curo
scientia	scientia
disciplina	disciplina
putatis	puto
aequamur	aequo
thales	thales
princeps	princeps1
physicorum	physicus
sciscitanti	sciscitor
croeso	croesus
divinitate	diuinitas
certum	certus
renuntiavit	renuntio
commeatus	commeatus
deliberandi	delibero
frustratus	frustror
deum	deus
opifex	opifex
christianus	christianus1
invenit	inuenio
ostendit	ostendo
exinde	exinde
totum	totus
deum	deus
quaeritur	quaero
adsignat	assigno
plato	plato
adfirmet	affirmo
factitatorem	factitator
universitatis	uniuersitas
inveniri	inuenio
facilem	facilis
inventum	inuenio
enarrari	enarro
difficilem	difficilis
pudicitia	pudicitia
provocemus	prouoco
lego	lego2
partem	pars
sententiae	sententia
atticae	attica
socratem	socrates
corruptorem	corruptor
adolescentium	adolescens1
pronuntiatum	pronuntio
sexum	sexus
femineum	femineus
mutat	muto2
christianus	christianus1
novi	nouus
phrynen	phryne
meretricem	meretrix
diogenis	diogenus
recumbentis	recumbo
ardori	ardor
subantem	subo
audio	audio
speusippum	speusippus
platonis	platon
schola	schola
adulterio	adulterium
perisse	pereo1
christianus	christianus1
uxori	uxor
soli	solus
masculus	masculus
nascitur	nascor
democritus	democritus
excaecando	excaeco
semetipsum	sui
{semetipsum}	ipse
mulieres	mulier
concupiscentia	concupiscentia
aspicere	aspicio
doleret	doleo
potitus	potior
incontinentiam	incontinentia
emendatione	emendatio
profitetur	profiteor
christianus	christianus1
salvis	saluus
oculis	oculus
feminas	femina
animo	animus
libidinem	libido
caecus	caecus
probitate	probitas
defendam	defendo
lutulentis	lutulentus
pedibus	pes
diogenes	diogens
superbos	superbus2
platonis	platon
toros	torus
superbia	superbia
deculeat	deculeo
christianus	christianus1
pauperem	pauper
superbit	superbio
modestia	modestia
certem	certe
pythagoras	Pythagoras
thurios	thurius
zenon	zenus
prienenses	prienensis
tyrannidem	tyrannis
adfectant	affecto
christianus	christianus1
aedilitatem	aedilitas
aequanimitate	aequanimitas
congrediar	congredior
lycurgus	lycurgus
apocarteresin	apocarteresis
optavit	opto
leges	lex
lacones	laco
emendassent	emendo
christianus	christianus1
damnatus	damno
gratias	gratia
agit	ago
fide	fides2
conparem	comparo2
anaxagoras	anaxagora
depositum	depositum
hospitibus	hospes
denegavit	denego
christianus	christianus1
fidelis	fidelis2
vocatur	uoco
simplicitate	simplicitas
consistam	consisto
aristotcles	aristotclis
familiarem	familiaris2
hermian	hermia
{hermian}	ne2
turpiter	turpiter
loco	locus
excedere	excedo1
christianus	christianus1
inimicum	inimicus1
laedit	laedo
aristoteles	aristoteles
turpiter	turpiter
alexandro	alexander
regendo	rego
adolatur	adolo
plato	plato
dionysio	dionysius
ventris	uenter
gratia	gratia
vcnditatur	ucndito
aristippus	aristippus
purpura	purpura
magna	magnus
gravitatis	grauitas
superficie	superficiens
nepotatur	nepoto
hippias	hippias
civitati	ciuitas
insidias	insidiae
disponit	dispono
occiditur	occido2
atrocitate	atrocitas
dissipatis	dissipo
unquam	umquam
temptavit	tento
christianus	christianus1
excedere	excedo1
regula	regula
disciplinae	disciplina
desinunt	desino
christiani	christianus1
philosophi	philosophus1
nomine	nomen
honore	honor
sapientiae	sapientia
perseverant	perseuero
simile	similis
philosophus	philosophus1
christianus	christianus1
graeciae	Graecia
discipulus	discipulus
caeli	caelum1
famae	fama
negotiator	negotiator
vitae	uita
verborum	uerbum
operator	operator
aedificator	aedificator
destructor	destructor
amicus	amicus1
inimicus	inimicus1
erroris	error
veritatis	ueritas
interpolator	interpolator
intcgrator	intugrator
expressor	expressor
furator	furator
custos	custos
antiquior	antiquus
veritas	ueritas
fallor	fallo
proficit	proficio
antiquitas	antiquitas
praestructa	praestruo
divinae	diuinus2
litteraturae	litteratura
facile	facile
credatur	credo
thesaurum	thesaurus
posteriori	posterus
sapientiae	sapientia
onus	onus
voluminis	uolumen
temperarem	tempero
excurrerem	excurro
probationem	probatio
poetarum	poeta
sophistarum	sophistes
prophetarum	propheta
fonte	fons
potaverit	poto
philosophi	philosophus1
sitim	sitis
ingenii	ingenium
ligaverunt	ligo2
conparent	comparo?
opinor	opinor
philosophia	philosophia
eiecta	eicio
thebaeis	thebaeus
spartiatis	spartio
argivis	argiuis
conantur	conor
homines	homo
gloriae	gloria
eloquentiae	eloquentia
solius	solius
libidinosi	libidinosus
sanctis	sanctus
scripturis	scriptura
offenderunt	offendo
digestis	digero
proprio	proprius
instituto	institutum
curiositatis	curiositas
propria	proprius
opera	opus1
verterunt	uerto
credentes	credo
divina	diuinus2
interpolarent	interpolo
intellegentes	intelligo
subnubila	subnubilus
iudaeis	Iudaei
obumbrata	obumbro
propria	proprius
simplicitas	simplicitas
veritatis	ueritas
scrupulositas	scrupulositas
humana	humanus
fidem	fides2
aspernata	aspernor
mutabat	muto2
incertum	incertus
miscuerunt	misceo
invenerant	inuenio
certum	certus
inventum	inuenio
solummodo	solummodo
deum	deus
invenerant	inuenio
disputaverunt	disputo
qualitate	qualitas
natura	natura
sede	sedes
disceptent	discepto
incorporalem	incorporalis
adseverant	asseuero
corporalem	corporalis
platonici	platonicus
stoici	stoicus
atomis	atomus
numeris	numerus
epicurus	epicurus
pythagoras	Pythagoras
igni	ignis
heraclito	heraclitos
platonici	platonicus
curantem	curo
epicurei	epicureus
otiosum	otiosus
inexercitum	inexercitus
humanis	humanus
positum	pono
mundum	mundus1
stoici	stoicus
figuli	figulus
extrinsecus	extrinsecus
torqueat	torqueo
molem	moles
mundum	mundus1
platonici	platonicus
gubernatoris	gubernator
exemplo	exemplum
maneat	maneo
regat	rego
mundo	mundus1
natus	nascor
innatusve	innascor
{innatusve}	ue
decessurus	decedo1
mansurusve	maneo
{mansurusve}	ue
variant	uario
animae	anima
statu	status1
divinam	diuinus2
aeternam	aeternus
dissolubilcm	dissolubilcis
contendunt	contendo
sensit	sentio
intulit	infero
reformavit	reformo
mirum	mirus
vetus	uetus
instrumentum	instrumentum
ingenia	ingenium
philosophorum	philosophus1
interverterunt	interuerto
semine	semen1
novitiolam	nouitiola
paraturam	paratura
viri	uir
opinionibus	opinio
philosophicas	philosophicus
sententias	sententia
adulteraverunt	adultero
una	unus
via	uia
obliquos	obliquus
inexplicabiles	inexplicabilis
tramites	trames
sciderunt	scindo
suggesserim	suggedio
nota	notus2
varietas	uarietas
sectae	secta
philosophis	philosophus1
adaequare	adaequo
varietate	uarietas
defensionum	defensio
iudicet	iudico
veritatem	ueritas
expedite	expedite
praescribimus	praescribo
adulteris	adulter1
regulam	regula
veritatis	ueritas
veniat	uenio
christo	christus
transmissa	transmitto
comites	comes
aliquanto	aliquanto
posteriores	posterus
diversi	diuersus
commmentatores	commmentator
probabuntur	probo
veritatem	ueritas
veritate	ueritas
constructa	construo
operantibus	operor
aemulationem	aemulatio
spiritibus	spiritus
erroris	error
adulteria	adulterium
huiusmodi	huiusmodi
salutaris	salutaris
disciplinae	disciplina
subornata	suborno
fabulae	fabula1
inmissae	immitto
similitudine	similitudo
fidem	fides2
infirmarent	infirmo
veritatis	ueritas
evincerent	euinco
putet	puto
christianis	christianus1
credendum	credo
poetis	poeta
philosophis	philosophus1
poetis	poeta
philosophis	philosophus1
existimet	existimo
credendum	credo
christianis	christianus1
ridemur	rideo
praedicantes	praedico1
deum	deus
iudicaturum	iudico
poetae	poeta
philosophi	philosophus1
tribunal	tribunal
inferos	inferi
ponunt	pono
gehennam	gehenna
comminemur	comminor
ignis	ignis
arcani	arcanum
subterraneam	subterraneus
poenam	poena
thesaurus	thesaurus
decachinnamur	decachinno
pyriphlegethon	pyriphlegethus
mortuos	mortuus2
amnis	amnis
paradisum	paradisus
nominemus	nomino
locum	locus
divinae	diuinus2
amoenitatis	amoenitas
recipiendis	recipio
sanctorum	sanctus
spiritibus	spiritus
destinatum	destino
maceria	maceria
igneae	igneus
zonae	zona
notitia	notitia
orbis	orbis
communis	communis
segregatum	segrego
elysii	Elysium
campi	campus1
fidem	fides2
occupaverunt	occupo2
oro	oro
philosophis	philosophus1
poetis	poeta
consimilia	consimilis
nonnisi	nonnitor
sacramentis	sacramentum
sacramentis	sacramentum
prioribus	prior
fideliora	fidelis2
magisque	magis
{magisque}	que
credenda	credo
imagines	imago
fidem	fides2
inveniunt	inuenio
sensibus	sensus
sacramenta	sacramentum
imagines	imago
posteriorum	posterius
forma	forma
sustinet	sustineo
nunquam	numquam
corpus	corpus
umbra	umbra
veritatem	ueritas
imago	imago
praecedit	praecedo1
age	ago
philosophus	philosophus1
adfirmet	affirmo
laberius	laber
sententia	sententia
pythagorae	Pythagoras
hominem	homo
mulo	mulus
colubram	colubra
muliere	mulier
opinionem	opinio
argumenta	argumentum
eloquii	eloquium
virtute	uirtus
distorserit	distorseo
consensum	consensus
movebit	moueo
fidem	fides2
infiget	infigo
animalibus	animal
abstinendi	abstineo
propterea	propterea
persuasum	persuadeo
bubulam	bubula
proavo	proauus
obsonet	obsono1
christianus	christianus1
homine	homo
hominem	homo
gaio	Gaius
gaium	Gaius
reducem	redux
repromittat	repromitto
lapidibus	lapis
saltim	saltem
coetibus	coetus
populo	populus1
exigetur	exigo
ratio	ratio
praeest	praesum1
animarum	anima
humanarum	humanus
reciprocandarum	reciproco
corpora	corpus
substantiam	substantia
redeant	redeo1
restitui	restituo
desinant	desino
locis	locus
otio	otium
opus	opus2
velimus	uolo3
partem	pars
lascivire	lasciuio
bestiam	bestia
reformari	reformo
defensione	defensio
proponimus	propono
dignius	dignus
credi	credo
hominem	homo
homine	homo
rediturum	redeo1
hominem	homo
qualitas	qualitas
animae	anima
restauraretur	restauro
conditionem	conditio
effigiem	effigies
ratio	ratio
restitutionis	restitutio
destinatio	destinatio
iudicii	iudicium
necessario	necessario
exhibebitur	exhibeo
boni	bonus
contrarii	contrarius
meriti	meritum
iudicium	iudicium
deo	deus
referat	refero
ideoque	ideo
{ideoque}	que
repraesentabuntur	repraesento
corpora	corpus
pati	patior
anima	anima
sola	solus
materia	materia
stabili	stabilis
carne	caro1
iudicio	iudicium
dei	deus
pati	patior
debent	debeo
animae	anima
carne	caro1
meruerunt	mereo
egerunt	ago
dissoluta	dissolutus
materia	materia
exhiberi	exhibeo
considera	considero
temetipsum	tenetipsum
o	o
homo	homo
fidem	fides2
invenies	inuenio
recogita	recogito
meminisses	memini
desieris	desino
auctoris	auctor
voluntate	uoluntas
voluit	uolo3
novi	nouus
eveniet	euenio
redde	reddo
rationem	ratio
require	requiro
facilius	facile
aeque	aeque
difficile	difficilis
nunquam	numquam
dubitabitur	dubito
credo	credo
dei	deus
viribus	uis
corpus	corpus
mundi	mundus1
morte	mors
vacationis	uacatio
inanitatis	inanitas
inposuit	impono
animatum	animatus
spiritu	spiritus
animarum	anima
animatore	animator
signatum	signo
humanae	humanus
resurrectionis	resurrectio
exemplum	exemplum
testimonium	testimonium
lux	lux
cotidie	cotidie
interfecta	interficio
resplendet	resplendeo
tenebrae	tenebrae
pari	par2
vice	uicis
decedendo	decedo1
succedunt	succedo1
sidera	sidus
defuncta	defunctus
vivescunt	uiuesco
tempora	tempus1
finiuntur	finio
incipiunt	incipio
fruetus	fruetus
consummantur	consummo
redeunt	redeo1
semina	semen1
corrupta	corrumpo
dissoluta	dissolutus
fecundius	fecunde
surgunt	surgo
pereundo	pereo1
servantur	seruo
interitu	interitus
reformantur	reformo
homo	homo
nomen	nomen
intellegas	intelligo
titulo	titulus
pythiae	pythiao
discens	disco
dominus	dominus
morientium	morior
resurgentium	resurgo
morieris	morior
pereas	pereo1
ubicumque	ubicumque1
resolutus	resoluo
materia	materia
destruxerit	destruo
hauserit	haurio
aboleverit	aboleo
nihilum	nihilum
prodegerit	prodigo
reddet	reddo
nihilum	nihilum
totum	totus
inquitis	inquio
moriendum	morior
resurgendum	resurgo
dominus	dominus
destinasset	destino
ingratis	ingratus
experireris	experior
conditionis	conditio
legem	lex
destinavit	destino
praedicavit	praedico1
ratio	ratio
universitatem	uniuersitas
diversitate	diuersitas
conposuit	compono
aemulis	aemulus1
substantiis	substantia
unitate	unitas
constarent	consto
vacuo	uacuus
solido	solidus2
animali	animal
inanimali	inanimalis
conprehensibili	comprehensibilis
inconprehensibili	incomprehensibilis
luce	lux
tenebris	tenebrae
vita	uita
morte	mors
aevum	aeuum
destinata	destino
distincta	distinctus2
condicione	condicio
conseruit	consero2
prima	primus
pars	pars
exordio	exordium
incolimus	incolo2
temporali	temporalis
aetate	aetas
finem	finis
defluat	defluo
sequens	sequor
expectamus	exspecto
infinitam	infinitus
aeternitatem	aeternitas
propagetur	propago2
finis	finis
limes	limes
medius	medius
interhiat	interhio
adfuerit	assum1
mundi	mundus1
species	species
transferatur	transfero
aeque	aeque
temporalis	temporalis
dispositioni	dispositio
aeternitatis	aeternitas
aulaei	aulaeum
vice	uicis
oppansa	oppando
restituetur	restituo
humanum	humanus
genus	genus1
expungendum	expungo
aevo	aeuum
boni	bonum
mali	malum1
meruit	mereo
exinde	exinde
pendendum	pendo
immensam	immensus
aeternitatis	aeternitas
perpetuitatem	perpetuitas
ideoque	ideo
{ideoque}	que
mors	mors
resurrectio	resurrectio
dei	deus
cultores	cultor
deum	deus
superinduti	superinduo
substantia	substantia
propria	proprius
aeternitatis	aeternitas
profani	profanus
integre	integre
deum	deus
poena	poena
aeque	aeque
iugis	iugum
ignis	ignis
natura	natura
divinam	diuinus2
subministrationem	subministratio
incorruptibilitatis	incorruptibitas
noverunt	nosco
philosophi	philosophus1
diversitatem	diuersitas
arcani	arcanus
publici	publicus2
ignis	ignis
longe	longe
usui	usus
humano	humanus
iudicio	iudicium
dei	deus
apparet	appareo
caelo	caelum1
fulmina	fulmen
stringens	stringo
terra	terra
vertices	uertex
montium	mons
eructans	eructo
absumit	absumo
exurit	exuro
erogat	erogo
reparat	reparo2
manent	maneo
montes	mons
ardentes	ardeo
caelo	caelum1
tangitur	tango
salvus	saluus
igni	ignis
decinerescat	decino
testimonium	testimonium
ignis	ignis
aeterni	aeternus
exemplum	exemplum
iugis	iugum
iudicii	iudicium
poenam	poena
nutrientis	nutrio
montes	mons
uruntur	uro
durant	duro
nocentes	nocens
dei	deus
hostes	hostis
solis	solus
praesumptiones	praesumptio
vocantur	uoco
philosophis	philosophus1
poetis	poeta
summae	superus
scientiae	scientia
insignia	insigne
ingenia	ingenium
prudentes	prudens
inepti	ineptus
honorandi	honoro
inridendi	irrideo
amplius	amplus
puniendi	punio
falsa	falsum
tuentur	tueor
merito	merito2
praesumptio	praesumptio
attamen	attamen
necessaria	necessarius2
inepta	ineptus
attamen	attamen
utilia	utilis
siquidem	siquidem
meliores	bonus
coguntur	cogo
credunt	credo
metu	metus
aeterni	aeternus
supplicii	supplicium
spe	spes
aeterni	aeternus
refrigerii	refrigerium
expedit	expedio
falsa	falsus
inepta	ineptus
expedit	expedio
vera	uerus
praesumi	praesumo
titulo	titulus
damnari	damno
prosunt	prosum1
praesumptio	praesumptio
damnat	damno
utilia	utile
inepta	ineptus
falsa	falsus
inepta	ineptus
noxia	noxius
similia	similis
poenas	poena
inrogatis	irrogo
vanis	uanus
fabulosis	fabulosus
inaccusatis	inaccusatus
inpunitis	impunitus
innoxiis	innoxius
eiusmodi	eiusmodi
inrisui	irrisus
iudicandum	iudico
gladiis	gladius
ignibus	ignis
crucibus	crux
bestiis	bestia
iniquitate	iniquitas
saevitiae	saeuitia
caecum	caecus
vulgus	uulgus
exsultat	exsulto
insultat	insulto
favor	fauor
vulgi	uulgus
iniquitate	iniquitas
captatur	capto
gloriantur	glorior
totum	totus
arbitrium	arbitrium
velim	uolo3
christianus	christianus1
damnabis	damno
damnari	damno
velim	uolo3
velim	uolo3
voluntatis	uoluntas
potestatis	potestas
vulgus	uulgus
vane	uanus
vexatione	uexatio
gaudet	gaudeo
gaudium	gaudium
vindicat	uindico
malumus	malo
damnari	damno
deo	deus
excidere	excido1
oderunt	odi
dolere	doleo
gaudere	gaudeo
debebant	debeo
consecutis	consequor
elegimus	eligo3
inquitis	inquio
querimini	queror
insequamur	insequor
pati	patior
vultis	uolo3
diligere	diligo3
debeatis	debeo
patimini	patior
vultis	uolo3
volumus	uolo3
pati	patior
verum	uerum4
more	mos
bellum	bellum
miles	miles
libens	libens
patitur	patior
trepidare	trepido
periclitari	periclitor
necesse	necesse
proeliatur	proelior
viribus	uis
vincens	uinco
proelio	proelium
gaudet	gaudeo
proelio	proelium
querebatur	queror
gloriam	gloria
consequitur	consequor
praedam	praeda
proelium	proelium
provocamur	prouoco
tribunalia	tribunal
discrimine	discrimen
capitis	caput
veritate	ueritas
certemus	certo1
victoria	uictoria
certaveris	certo1
obtinere	obtineo
victoria	uictoria
gloriam	gloria
placendi	placeo
deo	deus
praedam	praeda
vivendi	uiuo
aeternum	aeternum2
obducimur	obduco
obtinuimus	obtineo
vicimus	uinco
occidimur	occido2
evadimus	euado2
obducimur	obduco
sarmenticios	sarmenticius
semaxios	semaxius
appelletis	appello1
stipitem	stipes
dimidii	dimidius
axis	axis
revincti	reuincio
sarmentorum	sarmentum
ambitu	ambitus
exurimur	exuro
victoriae	uictoria
palmata	palmatum
vestis	uestis
curru	currus
triumphamus	triumpho
merito	merito2
victis	uinco
placemus	placo
propterea	propterea
desperati	desperatus
perditi	perditus
existimamur	existimo
desperatio	desperatio
perditio	perditio
gloriae	gloria
famae	fama
vexillum	uexillum
virtutis	uirtus
extollunt	extollo
mucius	mucius
dexteram	dextera
libens	libens
ara	ara
reliquit	relinquo
o	o
sublimitas	sublimitas
animi	animus
empedocles	empedocles
totum	totus
catanensium	catanenses
aetnaeis	aetnaeus
incendiis	incendium
donavit	dono
o	o
vigor	uigor
mentis	mens
carthaginis	carthago
conditrix	conditrix
rogo	rogo
matrimonium	matrimonium
o	o
praeconium	praeconium
castitatis	castitas
regulus	regulus
unus	unus
hostibus	hostis
viveret	uiuo
toto	totus
corpore	corpus
cruces	crux
patitur	patior
o	o
virum	uir
fortem	fortis
captivitate	captiuitas
victorem	uictor
anaxarchus	anaxarchus
exitum	exitus
tisanae	tisanus
pilo	pilum
contunderetur	contundo
tunde	tundo
tunde	tundo
anaxarchi	anaxarchus
follem	follis
anaxarchum	anaxarchus
fundis	fundus
o	o
philosophi	philosophus1
magnanimitatem	magnanimitas
exitu	exitus
iocabatur	iocor
omitto	omitto
gladio	gladius
proprio	proprius
genere	genus1
mortis	mors
mitiore	mitis
laude	laus
pepigerunt	pango
tormentorum	tormentum
certamina	certamen
coronantur	corono
attica	attica
meretrix	meretrix
carnifice	carnifex
fatigato	fatigo
postremo	posterius
linguam	lingua
comesam	comedo2
faciem	facies
tyranni	tyrannus
saevientis	saeuio
exspuit	exspuo
exspueret	exspuo
vocem	uox
coniuratos	coniurati
confiteri	confiteor
victa	uinco
voluisset	uolo3
zeno	zenus
eleates	eleato
consultus	consultus
dionysio	dionysius
philosophia	philosophia
praestaret	praesto1
respondisset	respondeo
contemptum	contemptus1
mortis	mors
inpassibilis	impassibilis
flagellis	flagellum
tyranni	tyrannus
obiectus	obicio
sententiam	sententia
mortem	mors
signabat	signo
laconum	laco
flagella	flagellum
oculis	oculus
hortantium	hortor
propinquorum	propinqui
acerbata	acerbo
honorem	honor
tolerantiae	tolerantia
domui	domus
conferunt	confero
sanguinis	sanguis
fuderint	fundo2
o	o
gloriam	gloria
licitam	licitus
humanam	humanus
praesumptio	praesumptio
perdita	perditus
nee	ne2
persuasio	persuasio
desperata	desperatus
reputatur	reputo
contemptu	contemptus1
mortis	mors
atrocitatis	atrocitas
omnimodae	omnimodus
patria	patrius
imperio	imperium
amicitia	amicitia
pati	patior
permissum	permitto
deo	deus
statuas	statua
defunditis	defundo2
imagines	imago
inscribitis	inscribo
titulos	titulus
inciditis	incido1
aeternitatem	aeternitas
monumentis	monumentum
praestatis	praesto1
mortuis	mortuus1
resurrectionem	resurrectio
veram	uerus
deo	deus
sperat	spero
deo	deus
patiatur	patior
insanus	insanus
agite	ago
boni	bonus
praesides	praeses
meliores	bonus
populum	populus1
christianos	christianus1
immolaveritis	immolo
cruciate	cruciatus
torquete	torqueo
damnate	damno
atterite	attero
probatio	probatio
innocentiae	innocentia
iniquitas	iniquitas
pati	patior
deus	deus
patitur	patior
proxime	prope1
lenonem	leno1
damnando	damno
christianam	christianus1
leonem	leo
confessi	confiteor
labem	labes
pudicitiae	pudicitia
atrociorem	atrox
poena	poena
morte	mors
reputari	reputo
proficit	proficio
exquisitior	exquisitus
crudelitas	crudelitas
inlecebra	illecebra
sectae	secta
efficimur	efficio
metimur	metior
semen	semen1
sanguis	sanguis
christianorum	christianus1
tolerantiam	tolerantia
doloris	dolor
mortis	mors
hortantur	hortor
cicero	cicero
tusculanis	tusculanum
seneca	seneca
fortuitis	fortuitus
diogenes	diogens
pyrrhon	pyrrhus
callinicus	callinicus
inveniunt	inuenio
verba	uerbum
discipulos	discipulus
christiani	christianus1
docendo	doceo
obstinatio	obstinatio
exprobratis	exprobro
magistra	magistra
contemplatione	contemplatio
concutitur	concutio
requirendum	requiro
intus	intus1
requisivit	requiro
accedit	accedo1
accessit	accedo1
pati	patior
exoptat	exopto
totam	totus
dei	deus
gratiam	gratia
redimat	redimo
veniam	uenia
compensatione	compensatio
sanguinis	sanguis
expediat	expedio
operi	opus1
delicta	delictum
donantur	dono
ibidem	ibidem
sententiis	sententia
gratias	gratia
agimus	ago
aemulatio	aemulatio
divinae	diuinus2
humanae	humanus
damnamur	damno
deo	deus
absolvimur	absoluo
valentiniani	Ualentinianus
frequentissimum	frequens
collegium	collegium
haereticos	haereticus
apostatis	aposto
veritatis	ueritas
fabulas	fabula1
facile	facile
disciplina	disciplina
terretur	terreo
curant	curo
occultare	occulto
praedicant	praedico1
praedicant	praedico1
occultant	occulto
custodiae	custodia
officium	officium
conscientiae	conscientia
officium	officium
confusio	confusio
praedicatur	praedico1
religio	religio
adseveratur	asseuero
eleusinia	eleusinia
haeresis	haeresis
atticae	attica
superstitionis	superstitio
tacent	taceo
pudor	pudor
idcirco	idcirco
aditum	aditus
cruciant	crucio
diutius	diu
initiant	initio
consignant	consigno
epoptas	epopta
quinquennium	quinquennium
instituunt	instituo
opinionem	opinio
suspendio	suspendium
cognitionis	cognitio
aedificent	aedifico
maiestatem	maiestas
exhibere	exhibeo
praestruxerunt	praestruo
cupiditatem	cupiditas
sequitur	sequor
silentii	silentium
officium	officium
attente	attente
custoditur	custodio
tarde	tarde
invenitur	inuenio
tota	totus
adytis	adytum
divinitas	diuinitas
tota	totus
suspiria	suspirium
epoptarum	epopta
totum	totus
signaculum	signaculum
linguae	lingua
simulacrum	simulacrum
membri	membrum
virilis	uirilis
revelatur	reuelo
naturae	natura
venerandum	uenerandus
nomen	nomen
allegorica	allegoricus
dispositio	dispositio
praetendens	praetendo
patrocinio	patrocinium
coactae	cogo
figurae	figura
sacrilegium	sacrilegium
obscurat	obscuro
convicium	conuicium
falsi	falsum
simulacris	simulacrum
excusat	excuso
destinamus	destino
haereticos	haereticus
sanctis	sanctus
nominibus	nomen
titulis	titulus
argumentis	argumentum
verae	uerus
religionis	religio
vanissima	uanus
turpissima	turpis
figmenta	figmentum
configurantes	configuro
facili	facilis
caritati	caritas
divinae	diuinus2
copiae	copia
occasione	occasio
succedere	succedo1
eleusinia	eleusinium
valentiniani	Ualentinianus
lenocinia	lenocinium
sancta	sanctus
silentio	silentium
magno	magnus
sola	solus
taciturnitate	taciturnitas
caelestia	caelestis
bona	bonus
fide	fides2
quaeras	quaero
concreto	concresco
vultu	uultus
suspenso	suspendo
supercilio	supercilium
altum	altus
subtiliter	subtiliter
temptes	tento
ambiguitates	ambiguitas
bilingues	bilinguis
communem	communis
fidem	fides2
adfirmant	affirmo
scire	scio
subostendas	subsutto
negant	nego
agnoscunt	agnosco
cominus	cominus
certes	certe
simplicitatem	simplicitas
caede	caedes
dispergunt	dispergo
discipulis	discipulus
propriis	proprius
committunt	committo
artificium	artificium
persuadeant	persuadeo
edoceant	edoceo
veritas	ueritas
docendo	doceo
persuadet	persuadeo
suadendo	suadeo
docet	doceo
ideoque	ideo
{ideoque}	que
simplices	simplex
notamur	noto
sapientes	sapiens1
deficere	deficio
cogatur	cogo
simplicitate	simplicitas
sapientia	sapientia
domino	dominus
utramque	uterque
iungente	iungo
prudentes	prudens
serpentes	serpens
simplices	simplex
columbae	columba
propterea	propterea
insipientes	insipiens
simplices	simplex
propterea	propterea
simplices	simplex
sapientes	sapiens1
nocentissimi	nocens
simplices	simplex
stultissimi	stultus
sapientes	sapiens1
malim	malo
partem	pars
meliori	bonus
sumi	sumo
vitio	uitium
praestat	praesto1
sapere	sapio
peius	male
errare	erro2
fallere	fallo
porro	porro
dei	deus
expectatur	exspecto
simplicitate	simplicitas
quaerendi	quaero
docet	doceo
sophia	sophis
valentini	Ualentinus
salomonis	salomo
infantes	infans1
testimonium	testimonium
christi	christus
sanguine	sanguis
litaverunt	lito
pueros	puer
vocem	uox
crucem	crux
clamant	clamo
pueri	puer
infantes	infans1
simplices	simplex
repuerascere	repuerasco
apostolus	apostolus
iubet	iubeo
deum	deus
malitia	malitia
infantes	infans1
simplicitatem	simplicitas
sapientes	sapiens1
sensibus	sensus
sapientiae	sapientia
ordinem	ordo
simplicitate	simplicitas
manantis	mano
summa	summum?
christum	christus
columba	columba
demonstrare	demonstro
solita	solitus
serpens	serpens
temptare	tento
primordio	primordium
divinae	diuinus2
pacis	pax
praeco	praeco
primordio	primordium
divinae	diuinus2
imaginis	imago
praedo	praedo
facilius	facile
simplicitas	simplicitas
sola	solus
deum	deus
agnoscere	agnosco
ostendere	ostendo
prudentia	prudentia
sola	solus
concutere	concutio
prodere	prodo
abscondat	abscondo
serpens	serpens
totamque	totus
{totamque}	que
prudentiam	prudentia
latebrarum	latebra
ambagibus	ambages
torqueat	torqueo
alte	alte
habitet	habito
caeca	caecus
detrudatur	detrudo
anfractus	anfractus1
seriem	series
evolvat	euoluo
tortuose	tortuose
procedat	procedo1
totus	totus
lucifuga	lucifuga
bestia	bestia
columbae	columba
domus	domus
simplex	simplex
editis	edo1
apertis	apertus
lucem	lux
amat	amo
figura	figura
spiritus	spiritus
sancti	sanctus
orientem	orior
christi	christus
figuram	figura
veritas	ueritas
erubescit	erubesco
solummodo	solummodo
abscondi	abscondo
pudebit	pudeo
aures	auris
deum	deus
recognoscere	recognosco
natura	natura
commisit	committo
quotidie	cotidie
operibus	opus1
sentit	sentio
solo	solum1
notum	notus2
unicum	unicus
putavit	puto
numero	numerus
nominavit	nomino
adoravit	adoro
alioquin	alioqui
turba	turba
frequentiam	frequentia
suadere	suadeo
domestico	domesticus2
principatu	principatus
incognitum	incognitus
transmovere	transmoueo
manifesto	manifesto2
occultum	occultus
retorquere	retorqueo
limine	limen
fidem	fides2
offendere	offendo
totam	totus
fabulam	fabula1
initietur	initio
infantia	infantia
somni	somnus
difficultates	difficultas
nutricula	nutricula
audisse	audio
lamiae	lamius
turres	turris
pectines	pecten
solis	sol
conscientia	conscientia
venerit	uenio
fidei	fides2
inveniat	inuenio
nomina	nomen
aeonum	aeonus
coniugia	coniugium
genimina	genimen
exitus	exitus
eventus	euentus
felicitates	felicitas
infelicitates	infelicitas
dispersae	dispergo
concisae	concido2
divinitatis	diuinitas
dubitabitne	dubito
{dubitabitne}	ne2
ibidem	ibidem
pronuntiare	pronuntio
fabulas	fabula1
genealogias	genealogia
indeterminatas	indeterminatus
apostoli	apostolus
spiritus	spiritus
pullulantibus	pullulo
seminibus	semen1
haereticis	haereticus
damnare	damno
praevenit	praeuenio
merito	merito2
simplices	simplex
merito	merito2
prudentes	prudens
facile	facile
producunt	produco
exerte	exertes
defendunt	defendo
edocent	edoceo
perdocent	perdoceo
astute	astute
pudenda	pudendus
inhumane	inhumane
honesta	honestus
simplices	simplex
scimus	scio
cuneum	cuneus
congressionis	congressio
armavimus	armo
detectorem	detector
designatorem	designator
totius	totus
conscientiae	conscientia
primamque	primus
{primamque}	que
victoriam	uictoria
auspicamur	auspicor
impendio	impendium
absconditur	abscondo
solummodo	solummodo
demonstrare	demonstro
destruere	destruo
novimus	nosco
optime	bene
originem	origo
scimus	scio
valentinianos	Ualentiniani
appellemus	appello1
abscesserunt	abscedo1
conditore	conditor1
origo	origo
deletur	deleo
mutatur	muto2
testatio	testatio
mutatio	mutatio
speraverat	spero
episcopatum	episcopatus
valentinus	Ualentinus
ingenio	ingenium
eloquio	eloquium
martyrii	martyrium
praerogativa	praerogatiuus
loci	locus
potitum	potior
indignatus	indignor
ecclesia	ecclesia
authenticae	authenticus
regulae	regula
abrupit	abrumpo
solent	soleo
animi	animus
prioratu	prioratus
exciti	excio
praesumptione	praesumptio
ultionis	ultio
accendi	accendo
expugnandam	expugno
conversus	conuerto
veritatem	ueritas
veteris	uetus
opinionis	opinio
semitam	semita
nactus	nanciscor
astu	astus
colubroso	colubrosus
viam	uia
delineavit	delineo
postmodum	postmodum
ptolemaeus	ptolemaeus
intravit	intro1
nominibus	nomen
numeris	numerus
aeonum	aeonus
distinctis	distinguo
personales	personalis
substantias	substantia
deum	deus
determinatas	determino
valentinus	Ualentinus
summa	summa
divinitatis	diuinitas
sensus	sensus
affectus	affectus1
motus	motus
incluserat	includo
deduxit	deduco
heracleon	heracleon
tramites	trames
secundus	secundus1
magus	magus1
marcus	marcus
imagines	imago
legis	lex
theotimus	theotimus
operatus	operor
nusquam	nusquam
valentinus	Ualentinus
valentiniani	Ualentinianus
valentinum	Ualentinus
solus	solus
hodiernum	hodiernus
antiochiae	Antiochia
axionicus	axionicus
memoriam	memoria
valentini	Ualentinus
integra	integer
custodia	custodia
regularum	regula
consolatur	consolor
alioquin	alioqui
haeresi	haeresis
suadere	suadeo
permissum	permitto
lupae	lupa
feminae	femina
formam	forma
quotidie	cotidie
supparare	supparo
sollemne	sollemnis
quidui	quiuis
spiritale	spiritalis
semen	semen1
unoquoque	unusquisque
recenseant	recenseo
novi	nouus
adstruxerint	astruo
revelationem	reuelatio
appellant	appello1
praesumptionem	praesumptio
charisma	charisma
ingenium	ingenium
unitatem	unitas
diversitatem	diuersitas
ideoque	ideo
{ideoque}	que
prospicimus	prospicio
seposita	sepositus
sollemni	sollemnis
dissimulatione	dissimulatio
plerosque	plerique
dividi	diuido
articulis	articulus
bona	bonus
fide	fides2
accipio	accipio
agnosco	agnosco
varietate	uarietas
innovatur	innouo
regularum	regula
colores	color
ignorantiarum	ignorantia
archetypis	archetypis
limes	limes
principalium	principalis
magistrorum	magister
adfectatis	affecto
ducibus	dux
passivorum	passius
discipulorum	discipulus
finxisse	fingo
materias	materia
viri	uir
sanctitate	sanctitas
praestantia	praestantia
insignes	insignis
antecessores	antecessor
haeresiarcharum	haeresiarcha
contemporales	contemporalis
instructissimis	instructus2
voluminibus	uolumen
prodiderunt	prodo
retuderunt	retundo
iustinus	iustinus
philosophus	philosophus1
martyr	martyr
miltiades	miltiades
ecclesiarum	ecclesia
sophista	sophistes
irenaeus	irenaeus
doctrinarum	doctrina
curiosissimus	curiosus
explorator	explorator
proculus	proculus
virginis	uirgo
senectae	senecta
christianae	christianus1
eloquentiae	eloquentia
dignitas	dignitas
opere	opus1
fidei	fides2
optaverim	opto
assequi	assequor
totum	totus
haereses	haeresis
pellunt	pello
finxisse	fingo
credantur	credo
mentietur	mentior
apostolus	apostolus
praedicator	praedicator
porro	porro
retractantur	retracto
otiosus	otiosus
stilo	stilus
materia	materia
fingat	fingo
libello	libellus
demonstrationem	demonstratio
promittimus	promitto
arcani	arcanum
nominibus	nomen
peregrinis	peregrinus2
coactis	cogo
compactis	compingo1
ambiguis	ambiguus
caligo	caligo1
suffundat	suffundo2
usuri	usura
demandabo	demando2
quorundam	quidam
graeco	Graecus
interpretatio	interpretatio
occurrit	occurro
expeditam	expeditus
nominis	nomen
formam	forma
quorundam	quidam
sexu	sexus
genera	genus1
conveniunt	conuenio
quorundam	quidam
usitatior	usitatus
graeco	Graecus
notitia	notitia
graeca	Graecus
ponemus	pono
significantiae	significantia
paginarum	pagina
limites	limes
aderunt	assum1
latinis	latinus
deerunt	desum1
graeca	Graecus
lineis	linea
desuper	desuper
notabuntur	noto
signum	signum
personalium	personalis
nominum	nomen
ambiguitates	ambiguitas
significatione	significatio
communicant	communico
distulerim	differo
congressionem	congressio
solam	solus
professus	profiteor
narrationem	narratio
sicubi	sicubi
indignitas	indignitas
meruerit	mereo
suggillari	sugillo
delibatione	delibatio
transfunctoria	transfunctorius
expugnatio	expugnatio
congressionis	congressio
iusionem	iusius
deputa	deputo
lector	lector
pugnam	pugna
ostendam	ostendo
imprimam	imprimo
vulnera	uulnus
ridebitur	rideo
alicubi	alicubi
materiis	materia
satisfiet	satisfio
digna	dignus
revinci	reuincio
gravitate	grauitas
adorentur	adoro
vanitati	uanitas
proprie	proprie
festivitas	festiuitas
cedit	cedo1
congruit	congruo
veritati	ueritas
ridere	rideo
laetans	laetor
aemulis	aemulus1
ludere	ludo
secura	securus
curandum	curo
risus	risus
rideatur	rideo
indignus	indignus
ubicunque	ubicumque1
dignus	dignus
risus	risus
officium	officium
incipiam	incipio
primus	primus
ennius	Ennius
poeta	poeta
romanus	Romanus
coenacula	coenaculum
maxima	magnus
caeli	caelum1
simpliciter	simpliciter
pronuntiavit	pronuntio
elati	effero2
situs	situs1
nomine	nomen
iovem	Iuppiter
epulantem	epulor
legerat	lego2
homerum	homerus
haeretici	haereticus
supernitates	supernitas
supernitatum	supernito
sublimitates	sublimitas
sublimitatum	sublimitas
habitaculum	habitaculum
dei	deus
suspenderint	suspendo
extulerint	effero2
expanderint	expando2
mirum	mirus
creatori	creator
enniana	ennianus
coenacula	coenaculum
aedicularum	aedicula
disposita	dispono
forma	forma
pergulis	pergula
superstructis	superstruo
unicuique	unusquisque
deo	deus
totidem	totidem2
scalas	scalae
distributis	distribuo
haereses	haeresis
meritorium	meritorius
mundus	mundus1
insulam	insula
feliculam	felicula
credas	credo
tabulata	tabulatum
caelorum	caelum1
nescio	nescio
valentinianorum	Ualentiniani
deus	deus
summas	superus
tegulas	tegula
habitat	habito
substantialiter	substantialiter
î	eo1
	
á	ab
¼	¼
°	°
á	ab
¿	¿
¶	¶
î	is
½	½
î	eo1
±	±
î	eo1
¤	¤
á	ab
½	½
³	³
î	eo1
»	»
îµî	eo1
¹	¹
î	eo1
¿	¿
î	eo1
½	½
appellant	appello1
personaliter	personaliter
î	eo1
ï	eo1
	
î	eo1
¿	¿
î	eo1
±	±
ï	eo1
	
ï	eo1
	
á	ab
½	½
´	´
î	eo1
½	½
î	eo1
¤	¤
á	ab
½	½
´	´
î	is
½	½
á	ab
¼	¼
	
ï	is
	
ï	eo1
	
á	ab
½	½
´	´
î	is
½	½
bython	bython
sublimibus	sublimis
habitanti	habito
congruebat	congruo
innatum	innascor
immensum	immensus
infinitum	infinitus
invisibilem	inuisibilis
aeternumque	aeternus
{aeternumque}	que
definiunt	definio
probent	probo
definiant	definio
scimus	scio
debere	debeo
expostulo	expostulus
huiusmodi	huiusmodi
denoto	denoueo
inveniuntur	inuenio
bythos	bythus
infinitis	infinitus
retro	retro1
aevis	aeuum
maxima	magnus
altissima	altus
quiete	quies
otio	otium
placidae	placidus
stupentis	stupeo
divinitatis	diuinitas
iussit	iubeo
epicurus	epicurus
volunt	uolo3
secundam	secundus1
personam	persona
ennoean	ennoean
charin	charis
sigen	sigen
insuper	insuper1
nominant	nomino
accedunt	accedo1
commendatissima	commendatus
quiete	quies
monere	moneo
proferendo	profero
initio	initium
semetipso	sui
{semetipso}	ipse
vice	uicis
seminis	semen1
sigae	siga
veluti	uelut1
genitalibus	genitalis
vulvae	uulua
locis	locus
collocat	colloco
suscipit	suscipio
praegnans	praegnans
efficitur	efficio
parit	pario2
silentio	silentium
sige	sigeo
parit	pario2
nus	nus
simillimum	similis
patri	pater
parem	par2
solus	solus
capere	capio2
suficit	suficio
immensam	immensus
incomprehensibilem	incomprehensibilis
magnitudinem	magnitudo
patris	pater
pater	pater
initium	initium
proprie	proprie
monogenes	monogenus
atquin	atqui
proprie	proprie
siquidem	siquidem
solus	solus
agnascitur	agnascor
processit	procedo1
femina	femina
veritas	ueritas
nomen	nomen
monogenes	monogenus
prior	prior
genitus	gigno
congruentius	congruenter
protogenes	protogenes
vocaretur	uoco
bythos	bythus
sige	sigeo
nus	nus
veritas	ueritas
prima	primus
quadriga	quadriga
defenditur	defendo
valentinianae	Ualentinianus
factionis	factio
matrix	matrix
origo	origo
cunctorum	cunctus
ibidem	ibidem
nus	nus
accepit	accipio
prolationis	prolatio
officium	officium
emittit	emitto
semetipso	sui
{semetipso}	ipse
sermonem	sermo
vitam	uita
retro	retro1
bytho	bythus
deo	deus
vita	uita
soboles	suboles
initium	initium
universitatis	uniuersitas
formationem	formatio
pleromatis	pleromo
totius	totus
emissa	emitto
fructum	fructus
hominem	homo
ecclesiam	ecclesia
procreat	procreo
ogdoadem	ogdoado
tetradem	tetrades
duplicem	duplex
coniugationibus	coniugatio
masculorum	masculus
feminarum	femina
cellas	cella
primordialium	primordialis
aeonum	aeonus
fraterna	fraternus
connubia	connubium
valentinianorum	Ualentinianus
deorum	deus
census	census
sanctitatis	sanctitas
maiestatis	maiestas
haereticae	haereticus
nescio	nescio
criminum	crimen
numinum	numen
turbam	turba
fontem	fons
reliquae	reliquus
fecunditatis	fecunditas
secunda	secundus1
tetras	teter
sermo	sermo
vita	uita
homo	homo
ecclesia	ecclesia
patris	pater
gloriam	gloria
fruticasset	frutico
numero	numerus
gestientes	gestio2
patri	pater
offerre	offero
ebulliunt	ebullio
fetus	fetus1
coniugales	coniugalis
copulam	copula
utriusque	uterque
naturae	natura
sermo	sermo
vita	uita
decuriam	decuria
aeonum	aeonus
fundunt	fundo2
illac	illac
homo	homo
ecclesia	ecclesia
duos	duo
amplius	ample
aequiparando	aequiparo
parentibus	parens1
duo	duo
decem	decem
efficiunt	efficio
procreaverunt	procreo
reddo	reddo
nomina	nomen
decuriam	decuria
bythios	bythius
mixis	misus
ageratos	agero
henosis	henosus
autophyes	autophyes
hedone	hedo
acinetos	acinetus
syncrasis	syncrasus
monogenes	monogenus
macaria	macarius
duodenarius	duodenarius
numerus	numerus
paracletus	paracletus
pistis	pistis
patricos	patricus
elpis	elpa
metricos	metricus
agape	agape
ainus	ainus
synesis	synesus
ecclesiasticus	ecclesiasticus
macariotes	macario
theletus	theletus
sophia	sophis
cogor	cogo
nomina	nomen
desiderent	desidero
proferre	profero
pari	par2
exemplo	exemplum
scholis	schola
karthaginiensibus	Carthaginienses
frigidissimus	frigidus
rhetor	rhetor
latinus	latinus
phosphorus	phosphorus
nomine	nomen
virum	uir
fortem	fortis
peroraret	peroro
venio	uenio
optimi	bonus
cives	ciuis
proelio	proelium
victoria	uictoria
felicitate	felicitas
ampliatus	amplio
gloriosus	gloriosus
fortunatus	fortunatus
maximus	magnus
triumphalis	triumphalis2
scholastici	scholasticus1
familiae	familia
phosphori	phosphorus
îîµá	iiua
¿	¿
acclamant	acclamo
audisti	audio
fortunatam	fortunatus
hedonen	hedones
acinetum	acinetus
theletum	theletus
acclama	acclama
familiae	familia
ptolemaei	ptolemaeus
îîµá	iiua
¿	¿
pleroma	pleroma
arcanum	arcanus
divinitatis	diuinitas
tricenariae	tricenarius
plenitudo	plenitudo
privilegia	priuilegium
numerorum	numerus
quaternarii	quaternarius
octonarii	octonarius
duodenarii	duodenarius
tricenario	tricenarius
fecunditas	fecunditas
tota	totus
deficit	deficio
castrata	castratus
vis	uis
potestas	potestas
libido	libido
genitalis	genitalis
aeonum	aeonus
numerorum	numerus
coagula	coagulum
superessent	supersum1
paedagogio	paedagogium
nomina	nomen
quinquaginta	quinquaginta
centum	centum
procreantur	procreo
hetaeri	hetaereo
syntrophi	syntrophus
noinantur	noino
exceptio	exceptio
personarum	persona
solus	solus
nus	nus
immensi	immensus
patris	pater
fruitur	fruor
notione	notio
gaudens	gaudeo
exultans	exsulto
maerentibus	maereo
nus	nus
voluerat	uolo3
temptaverat	tento
communicare	communico
norat	nosco
incompreheusibilis	incompreheusibilis
pater	pater
intercessit	intercedo1
mater	mater
sige	sigeo
haereticis	haereticus
tacere	taceo
praescribit	praescribo
patris	pater
nutu	nutus
volentis	uolens
desiderium	desiderium
accendi	accendo
macerantur	macero
semetipsos	sui
{semetipsos}	ipse
tacita	tacitus
cupidine	cupido
cognoscendi	cognosco
patrem	pater
uruntur	uro
scelus	scelus
duodecim	duodecim
aeonibus	aeo
homo	homo
ecclesia	ecclesia
ediderant	edo1
novissima	nouus
natu	natu
aeon	aeon
soloecismus	soloecis
sophia	sophis
nomen	nomen
incontinentia	incontinentia
aine	aio
coniugis	coniux
theleti	theletus
societate	societas
prorumpit	prorumpo
patrem	pater
inquirere	inquiro
genus	genus1
contrahit	contraho
vitii	uitium
exorsum	exordior
nun	nunc
sophiam	sophia
derivarat	deriuo
solent	soleo
vitia	uitium
corpore	corpus
alibi	alibi
innata	innascor
membrum	membrum
perniciem	pernicies
efflare	efflo
praetextu	praetextus1
dilectionis	dilectio
patrem	pater
aemulatio	aemulatio
superabat	supero
nun	nunc
patre	pater
gaudentem	gaudeo
impossibilia	impossibilis
contendens	contendo
sophia	sophis
frustrata	frustror
vincitur	uinco
difficultate	difficultas
extenditur	extendo
affectione	affectio
modico	modicus
abfuit	absum1
vi	uis
dulcedinis	dulcedo
laboris	labor1
devorari	deuoro
reliquam	reliquus
substantiam	substantia
dissolvi	dissoluo
pereundo	pereo1
cessasset	cesso
bono	bonus
fato	fatum
horon	horon
incursasset	incurso
vis	uis
fundamentum	fundamentum
universitatis	uniuersitas
extrinsecus	extrinsecus
custos	custos
crucem	crux
appellant	appello1
lytroten	lytrotes
carpisten	carpistes
sophia	sophis
periculo	periculum
exempta	eximo
tarde	tarde
persussa	persutio
declinata	declino
investigatione	inuestigatio
patris	pater
conquievit	conquiesco
totam	totus
animationem	animatio
enthymesin	enthymesis
passione	passio
insuper	insuper1
acciderat	accido1
exposuit	expono
exitum	exitus
sophiae	sophia
restitutionem	restitutio
somniaverunt	somnio
irritos	irritus
conatus	conatus
spei	spes
deiectionem	deiectio
deformatam	deformo2
pallore	pallor
credo	credo
macie	macies
incuria	incuria
formae	forma
patrem	pater
denegatum	denego
dolebat	doleo
amissum	amitto
dehinc	dehinc
maerore	maeror
semetipsa	sui
{semetipsa}	ipse
sola	solus
opera	opus1
coniugii	coniugium
concepit	concipio
procreat	procreo
feminam	femina
miraris	miror
gallina	gallina
sortita	sortior
parere	pareo
vultures	uultur
feminas	femina
parere	pareo
masculo	masculus
mater	mater
metuere	metuo
postremo	posterius
finis	finis
insisteret	insisto
haerere	haereo
ratione	ratio
casus	casus
curare	curo
occultatione	occultatio
remedia	remedium
nusquam	nusquam
tragoediae	tragoedia
comoediae	comoedia
forma	forma
mutuaretur	mutuor
exponendi	expono
citra	citra2
pudorem	pudor
natum	nascor
malis	malum1
suspicit	suspicio2
convertit	conuerto
patrem	pater
incassum	incassum
enisa	enitor2
vires	uis
deserebant	desero2
preces	prex
succidit	succido1
tota	totus
propinquitas	propinquitas
supplicat	supplico
maxime	magis2
nus	nus
mali	malum1
sophiae	sophia
exitus	exitus
vacuit	uacuo1
aerumnae	aerumna
operantur	operor
siquidem	siquidem
conflictatio	conflictatio
materiae	materia
originem	origo
pervenit	peruenio
ignorantia	ignorantia
pavor	pauor
maeror	maeror
substantiae	substantia
flunt	flo
pater	pater
motus	motus
horon	horon
monogenem	monogenus
nun	nunc
promit	promo
imagine	imago
feminam	femina
marem	mas
patris	pater
sexu	sexus
variant	uario
adiciunt	adicio
horon	horon
metagogea	metagogeus
circumductorem	circumductor
vocari	uoco
horotheten	horothetes
praedicant	praedico1
opera	opus1
repressam	reprimo
illicitis	illicitus
purgatam	purgo
malis	malum1
deinceps	deinceps
confirmatam	confirmo
sophiam	sophia
coniugio	coniugium
restitutam	restituo
pleromatis	pleromo
censu	census
remansisse	remaneo
enthymesin	enthymesis
appendicem	appendix
passionem	passio
horo	horus
relegatam	relego1
crucifixam	crucifigo
malum	malum3
foras	foras
spiritalem	spiritalis
substantiam	substantia
naturalem	naturalis
impetum	impetus
aeonis	aeonus
informem	informis
inspeciatam	inspecio
adprehendisset	apprehendo
ideoque	ideo
{ideoque}	que
fructum	fructus
infirmum	infirmus
feminam	femina
pronuntiatam	pronuntio
enthymesin	enthymesis
extorrem	extorris
matrem	mater
sopbiam	sopbia
coniugi	coniux
reducem	redux
monogenes	monogenus
nus	nus
otiosus	otiosus
patris	pater
cura	cura
prospectu	prospectus
solidandis	solido
pleromati	pleromatus
muniendo	munio2
figendo	figo
eiusmodi	eiusmodi
concussio	concussio
incuteret	incutio
novam	nouus
excludit	excludo
copulationem	copulatio
christum	christus
spiritum	spiritus
sanctum	sanctus
turpissimum	turpis
putem	puto
duorum	duo
masculorum	masculus
femina	femina
spiritus	spiritus
sanctus	sanctus
vulneratur	uulnero
femina	femina
masculus	masculus
numen	numen
unum	unus
procurare	procuro
concinnationem	concinnatio
aeonum	aeonus
officii	officium
societate	societas
duae	duo
scholae	schola
duae	duo
cathedrae	cathedra
inauguratio	inauguratio
dividendae	diuido
doctrinae	doctrina
valentini	Ualentinus
christi	christus
inducere	induco
aconas	acona
naturam	natura
coniugiorum	coniugium
innati	innascor
coniectationem	coniectatio
idoneos	idoneus
efficere	efficio
generandi	genero
agnitionem	agnitio
patris	pater
capere	capio2
comprehendere	comprehendo
auditu	auditus
compotiri	compotior
monogenem	monogen
tolerabo	tolero
disserunt	dissero2
patrem	pater
nosse	nosco
denotabo	denoto
doctrinae	doctrina
perversitatem	peruersitas
docebantur	doceo
incomprehensibile	incomprehensibilis
patris	pater
causam	causa
perpetuitatis	perpetuitas
comprehensibile	comprehensibilis
generationis	generatio
formationis	formatio
rationem	ratio
dispositione	dispositio
opinor	opinor
insinuatur	insinuo
expedire	expedio
deum	deus
adprehendi	apprehendo
siquidem	siquidem
inadprehensibile	inapprehensibilis
perpetuitatis	perpetuitas
adprehensibile	apprehensibilis
perpetuitatis	perpetuitas
nativitatis	natiuitas
formationis	formatio
egentium	egens
perpetuitatis	perpetuitas
filium	filius
constituunt	constituo
adprehensibilem	apprehensibilis
patris	pater
adprehendatur	apprehendo
prolatus	profero
christus	christus
edocuit	edoceo
spiritus	spiritus
sancti	sanctus
propria	proprius
doctrinae	doctrina
studio	studium
peraequati	peraequor
gratiarum	gratia
actionem	actio
prosequi	prosequor
nossent	nosco
veram	uerus
inducerentur	induco
quietem	quies
forma	forma
scientia	scientia
peraequantur	peraequor
unusquisque	unusquisque
refunduntur	refundo2
nus	nus
homines	homo
theletos	theletus
aeque	aeque
feminae	femina
sigas	sigo
zoas	zoas
ecclesias	ecclesia
fortunatas	fortunatus
ovidius	ouide
metamorphoses	metamorphosis
delevisset	deleo
maiorem	magnus
cognovisset	cognosco
exinde	exinde
refecti	reficio
constabiliti	consto
requiem	requies
veritate	ueritas
compositi	compositus
magno	magnus
gaudii	gaudium
fructu	fructus
hymnis	hymnus
patrem	pater
concinunt	concino
diffundebatur	diffundo2
laetitia	laetitia
bene	bene
cantantibus	canto
filiis	filius
nepotibus	nepos1
diffunderetur	diffundo2
iocunditate	iocunditas
pleromate	pleromate
liberato	libero
nauclerus	nauclerus
dedecore	dedecus
laetatur	laetor
quotidie	cotidie
nauticorum	nautici
lascivias	lasciuia
gaudiorum	gaudium
nautae	nauta
symbolam	symbola
exultant	exsulto
aeones	aeon
unum	unus
forma	forma
nedum	nedum1
sententia	sententia
convenientibus	conuenio
novis	nouus
fratribus	frater
magistris	magister
christo	christus
spiritu	spiritus
sancto	sanctus
optimum	bonus
pulcherrimum	pulcher
unusquisque	unusquisque
florebat	floreo
conferunt	confero
medium	medius
vane	uaneo
opinor	opinor
unum	unus
peraequatione	peraequatio
vacabat	uaco
symbolae	symbola
ratio	ratio
ferme	ferme
varietatis	uarietas
gratia	gratia
constat	consto
unum	unus
bonum	bonum
conterebant	contero
ratio	ratio
forma	forma
peraequationis	peraequatio
aere	aes
collaticio	collaticius
honorem	honor
gloriam	gloria
patris	pater
pulcherrimum	pulcher
pleromatis	pleromo
sidus	sidus
fructumque	fructus
{fructumque}	que
perfectum	perfectus2
compingunt	compingo1
iesum	iesus
cognominant	cognomino
soterem	soter
christum	christus
sermonem	sermo
patritis	patritus
defloratione	defloratio
constructum	construo
graculum	graculum
aesopi	aesopus
pandoram	pandor
hesiodi	hesiodum
acci	accio
patinam	patina
nestoris	nestor
cocetum	cocetus
miscellaneam	miscellaneus
ptolemaei	ptolemaeus
propius	prope2
atticis	atticus
curis	cura
pancarpian	pancarpias
vocari	uoco
otiosis	otiosus
auctoribus	auctor
nominum	nomen
sigillarium	sigillarius
extrinsecus	extrinsecus
inornassent	inorno
satellites	satelles
angelos	angelus
proferunt	profero
par	par2
genus	genus1
soteri	soter
consubstantivos	consubstantiuus
ambigue	ambigue
positum	pono
inveni	inuenio
eminentia	eminens
satellites	satelles
coaequales	coaequalis
continet	contineo
ordo	ordo
primam	primus
processionem	processio
nascentium	nascor
nubentium	nubo
generantium	genero
aeonum	aeonus
sophiae	sophia
desiderio	desiderium
patris	pater
periculosissimum	periculosus
casum	casus
hori	horus
oportunissimum	opportunus
auxilium	auxilium
enthymeseos	enthymesii
coniunctae	coniungo
passionis	passio
expiatum	expio
christi	christus
spiritus	spiritus
sancti	sanctus
paedagogatum	paedagogatus
aeonum	aeonus
tutelarem	tutelaris
reformatum	reformo
soteris	soter
pavoninum	Pauoninus
ornatum	ornatus2
angelorum	angelus
comparaticium	comparaticus
antistatum	antistatus
superest	supersum1
valete	ualeo
plaudite	plaudo
superest	supersum1
audite	audio
proficite	proficio
coetum	coetus
pleromatis	pleromo
decucurrisse	decurro
prima	primus
tragoediae	tragoedia
scena	scena
siparium	siparium
cothurnatio	cothurnatio
pleroma	pleroma
sinu	sinus
patris	pater
ambitum	ambitus
hori	horus
custodis	custos
libero	liber2
deus	deus
enthymesis	enthymesis
achamoth	achamoth
abhinc	abhinc
scriptum	scribo
solo	solum1
ininterpretabili	ininterpretabilis
nomine	nomen
vitio	uitium
individuae	indiuiduus
passionis	passio
explosa	explodo
loca	locus
luminis	lumen
aliena	alienus2
pleromatis	pleromo
vacuum	uacuus
inane	inanis
epicuri	epicurum
miserabilis	miserabilis
loco	locus
forma	forma
intempestiva	intempestiuus
abortiva	abortiuus
genitura	gigno
flectitur	flecto
superioribus	superus
christus	christus
deducitur	deduco
horon	horon
aborsum	aborsum
informet	informo
viribus	uis
solius	solius
substantiae	substantia
scientiae	scientia
forma	forma
peculio	peculium
relinquitur	relinquo
iteratur	itero
odor	odor
incorruptibilitatis	incorruptibitas
compos	compos
casus	casus
potiorum	potius
desiderio	desiderium
superaretur	supero
misericordia	misericordia
functus	fungor
spiritus	spiritus
sancti	sanctus
societate	societas
recurrit	recurro
christus	christus
pleroma	pleroma
usus	utor
liberalitatibus	liberalitas
nomina	nomen
accedere	accedo1
enthymesis	enthymedo
actu	actus1
achamoth	achamoth
quaeritur	quaero
sophia	sophis
patre	pater
manat	mano
spiritus	spiritus
sanctus	sanctus
angelo	angelus
accipit	accipio
christi	christus
derelictam	derelinquo
senserat	sentio
desiderium	desiderium
prosiluit	prosilio
lumen	lumen
inquirere	inquiro
noverat	nosco
invisibiliter	inuisibiliter
operatum	operor
lumen	lumen
ignotum	ignotus
requirebat	requiro
temptavit	tento
adprehendisset	apprehendo
iioros	iuppis
matri	mater
prospere	prospere
venerat	uenio
nune	nunes
importune	importune
filiae	filia
occurrisset	occurro
inclamaverit	inclamo
iao	iaus
porro	porro
quirites	Quirites
fidem	fides2
caesaris	caesar
invenitur	inuenio
iao	iaus
scripturis	scriptura
depulsa	depello
quominus	quominus
pergeret	pergo
supervolare	superuolo2
crucem	crux
horon	horon
catulli	catullus
laureolum	laureolum
exercitata	exercitatus
destituta	destituo
passioni	passio
trica	trica
multiplici	multiplex
perplexa	perplexus
genere	genus1
coepit	coepio
adfligi	affligo
maerere	maereo
perpetrasset	perpetro
inceptum	incipio
metu	metus
luce	lux
vita	uita
orbaretur	orbo
consternatione	consternatio
ignorantia	ignorantia
mater	mater
aeon	aeon
condicione	condicio
deterius	deterius
insurgente	insurgo
fluctu	fluctus
conversionis	conuersio
christum	christus
vivificata	uiuifico
conversionem	conuersio
temperata	temperatus2
age	ago
discant	disco
pythagorici	pythagoricus
agnoscant	agnosco
stoici	stoicus
plato	platum
materia	materia
innatam	innascor
volunt	uolo3
originem	origo
substantiam	substantia
traxerit	traho
struem	strues
mundi	mundus1
mercurius	mercurius
trismegistus	trismigistus
magister	magister
physicorum	physicus
recogitavit	recogito
audisti	audio
conversionem	conuersio
genus	genus1
passionis	passio
anima	anima
mundi	mundus1
constitiese	constituo
demiurgi	demiurgo
dei	deus
audisti	audio
maerorem	maeror
timorem	timor
initiata	initio
lacrimis	lacrima
universa	uniuersus
aquarum	aqua
natura	natura
manavit	mano
aestimandum	aestimo
exitum	exitus
duxerit	duco
lacrimarum	lacrima
generibus	genus1
inundaverit	inundo
salsas	salsus
amaras	amarus
dulces	dulcis
calidas	calidus
frigidas	frigidus
guttas	gutta
bituminosas	bituminosus
ferruginantes	ferrugino
sulphurantes	sulfuro
venenatas	uenenatus
nonacris	nonacri
sudaverit	sudo
alexandrum	alexander
occidit	occido1
lyncestarum	lyncestus
defluxerit	defluo
ebrios	ebrius
efficit	efficio
salmacis	salmax
solverit	soluo
masculos	masculus
molles	mollis
caelestes	caelestis
imbres	imber
pipiavit	pipio2
achamoth	achamoth
cisternis	cisternus
alienos	alienus2
luctus	luctus
lacrimas	lacrima
servare	seruo
curamus	curo
consternatione	consternatio
pavore	pauor
corporalia	corporalis
elementa	elementum
ducta	duco
circumstantia	circumsto
solitudinis	solitudo
circumspectu	circumspectus1
destitutionis	destitutio
ridebat	rideo
conspecti	conspicio
christi	christus
recordans	recordor
gaudii	gaudium
risu	risus
lumen	lumen
effulsit	effulgeo
providentiae	prouidentia
beneficium	beneficium
ridere	rideo
cogebat	cogo
idcirco	idcirco
tenebris	tenebrae
moraremur	moror1
obstupescas	obstupesco
laetitia	laetitia
splendidum	splendidus
elementum	elementum
radiaverit	radio
mundo	mundus1
maestitia	maestitia
necessarium	necessarius2
instrumentum	instrumentum
defluxerit	defluo
saeculo	saeculum
o	o
risum	risus
illuminatorem	illuminator
o	o
fletum	fletus
rigatorem	rigator
remedio	remedium
agere	ago
loci	locus
horrore	horror
obscuritatem	obscuritas
discussisset	discutio
ridere	rideo
voluisset	uolo3
cogeretur	cogo
desertores	desertor
supplicare	supplico
convertitur	conuerto
preces	prex
more	mos
materno	maternus
christus	christus
pigebat	piget
pleroma	pleroma
proficisci	proficiscor
vicarium	uicarius1
praeficit	praeficio
paracletum	paracletus
soterem	soter
iesus	Iesus
largito	largior
patre	pater
universorum	uniuersus
aeonum	aeonus
summam	superus
potestatem	potestas
subiciendis	subicio
apostolum	apostolus
conderentur	condo
emittit	emitto
officio	officium
comitatu	comitatus1
coaetaneorum	coaetaneus
augelorum	augelus
credas	credo
duodecim	duodecim
fascibus	fascis
adventu	aduentus
pompatico	pompaticus
concussa	concutio
achamoth	achamoth
velamentum	uelamentum
obduxit	obduco
officio	officium
primo	primo
venerationis	ueneratio
verecundiae	uerecundia
dehinc	dehinc
contemplatur	contemplor
fructiferumque	fructifer
{fructiferumque}	que
suggestum	suggestus
conceperat	concipio
viribus	uis
occurrit	occurro
î	eo1
	
á	ab
½	½
»	»
ï	eo1
	
î	eo1
¹	¹
îµ	iu
î	eo1
§	§
î	eo1
±	±
á	ab
¿	¿
	
ï	is
	
îµ	iu
opinor	opinor
susceptam	suscipio
confirmat	confirmo
conformat	conformo
agnitione	agnitio
iniuriis	iniuria
passionis	passio
expumicat	expumico
neglegentia	negligentia
exterminium	exterminium
discretis	discerno
acciderat	accido1
casibus	casus
matris	mater
exercitata	exercito
vitia	uitium
usu	usus
viriosa	uiriosus
confudit	confundo2
massaliter	massaliter
solidata	solido
defixit	defigo
seorsum	seorsum1
materiae	materia
corporalem	corporalis
paraturam	paratura
commutans	commuto2
incorporali	incorporalis
passione	passio
indita	indo
habilitatem	habilitas
naturam	natura
pervenire	peruenio
aemulas	aemulus2
aequiparantias	aequiparantia
corpulentiarum	corpulentia
duplex	duplex
substantiarum	substantia
condicio	condicio
ordinaretur	ordino
vitiis	uitium
pessima	malus3
conversione	conuersio
passionalis	passionalis
materia	materia
commisit	committo
hermogene	hermogene
deum	deus
materia	materia
operatum	operor
cuncta	cunctus
praesumunt	praesumo
abhinc	abhinc
achamoth	achamoth
expedita	expeditus
malis	malum1
proficit	proficio
opera	opus1
maiora	magnus
frugescit	frugesco
gaudio	gaudium
infelicitate	infelicitas
successus	successus
concalefacta	concalefacio
simulque	simul
{simulque}	que
contemplatione	contemplatio
angelicorum	angelicus
luminum	lumen
subfermentata	suppermento
pudet	pudeo
exprimere	exprimo
subavit	subo
interea	interea
conceptu	conceptus1
intumuit	intumesco
spiritali	spiritalis
imaginem	imago
vis	uis
laetantis	laetor
laetitia	laetitia
prurientis	prurio
intentionis	intentio
imbiberat	imbibo2
intimarat	intimo
peperit	pario2
exinde	exinde
trinitas	trinitas
generum	gener
trinitate	trinitas
causarum	causa
unum	unus
materiale	materialis
passione	passio
animale	animalis
conversione	conuersio
tertium	tertius
spiritale	spiritalis
imaginatione	imaginatio
auctoritate	auctoritas
triam	tres
liberorum	liberi
agendis	ago
exercitior	exercitus2
formare	formo
singula	singulus
genera	genus1
constituit	constituo
spiritale	spiritalis
attingere	attingo
spiritalis	spiritalis
fare	for
paria	par2
consubstantiva	consubstantiuus
alterutrum	alteruter
valere	ualeo
societas	societas
naturae	natura
negavit	nego
animo	animus
unum	unus
animale	animalis
convertit	conuerto
prolatis	profero
soteris	soto
disciplinis	disciplina
magno	magnus
horrore	horror
blasphemiae	blasphemia
pronuntiandum	pronuntio
legendum	lego2
audiendum	audio
deum	deus
fingit	fingo
haereticorum	haereticus
patrem	pater
demiurgum	demiurgus
regem	rex
universorum	uniuersum
achamoth	achamoth
occulto	occultus
sentiens	sentio
sigillario	sigillarius
extrinsecus	extrinsecus
ductu	ductus
operationem	operatio
movebatur	moueo
personarum	persona
operibus	opus1
ambiguitate	ambiguitas
nomen	nomen
metropatoris	metropator
miscuerunt	misceo
distinctis	distinguo
appellationibus	appellatio
status	status1
situs	situs1
operum	opus1
animalium	animal
substantiarum	substantia
dexteram	dextera
commendant	commendo
patrem	pater
nuncupent	nuncupo
materiarum	materia
laevam	laeua?
delegant	delego1
demiurgum	demiurgus
nominent	nomino
regem	rex
communiter	communiter
universitatem	uniuersitas
nominum	nomen
proprietas	proprietas
competit	competo
proprietati	proprietas
operum	opus1
nomina	nomen
deberet	debeo
vocitari	uocito
agebantur	ago
achamoth	achamoth
honorem	honor
aeonum	aeonus
imagines	imago
commentatam	commentor2
soterem	soter
auctorem	auctor
detorquent	detorqueo
operatus	operor
imaginem	imago
patris	pater
invisibilis	inuisibilis
incogniti	incognitus
incognitam	incognitus
invisibilem	inuisibilis
demiurgo	demiurgo
demiurgum	demiurgus
nun	nunc
filium	filius
effingeret	effingo
archangeli	archangelus
demiurgi	demiurgo
opus	opus1
reliquos	reliquus
aeonas	aeona
exprimerent	exprimo
imagines	imago
audio	audio
trium	tres
quaero	quaero
vis	uolo?
imagines	imago
rideam	rideo
perversissimi	peruersus
pictoris	pictor
feminam	femina
achamoth	achamoth
imaginem	imago
patris	pater
ignarum	ignarus
matris	mater
demiurgum	demiurgus
patris	pater
imaginem	imago
nu	nu
ignorantis	ignoro
patrem	pater
angelos	angelus
famulos	famulus1
simulacra	simulacrum
dominorum	dominus
mulum	mulus
asino	asinus
pingere	pingo
ptolemaeum	ptolemaeus
describere	describo
valentino	Ualentinus
demiurgus	demiurgus
pleromatis	pleromo
limites	limes
constitutus	constituo
ignominiosa	ignominiosus
aeterni	aeternus
exsilii	exsilium
vastitate	uastitas
novam	nouus
provinciam	prouincia
condidit	condo
mundum	mundus1
repurgata	repurgo
confusione	confusio
distincta	distinctus2
diversitate	diuersitas
duplicis	duplex
substantiae	substantia
disclusae	discludo
animalium	animal
materiarum	materia
incorporalibus	incorporalis
corpora	corpus
aedificat	aedifico
gravis	grauis
levia	leuis1
sublimantia	sublimo
vergentia	uergo
caelestia	caelestis
terrena	terrenus
caelorum	caelum1
septemplicem	septemplex
scenam	scena
solio	solium
desuper	desuper
finit	finio
sabbatum	sabbatum
hebdomade	hebdoma
sedis	sedes
ogdoada	ogdoadus
mater	mater
achamoth	achamoth
argumento	argumentum
ogdoadis	ogdoadus
primogenitalis	primogenitalis
caelos	caelum1
noã	noua
«	«
ros	ros
deputant	deputo
angelos	angelus
demiurgum	demiurgus
paradisum	paradisus
archangelum	archangelus
quartum	quartus
caelum	caelum1
tertium	tertius
pangunt	pango
virtute	uirtus
sumpserit	sumo
adam	ada
deversatus	deuersor2
nubeculas	nubecula
arbusculas	arbuscula
meminerat	memini
ptolemaeus	ptolemaeus
puerilium	puerilis
dicibulorum	dicibulum
mari	mare
poma	pomum
nasci	nascor
arbore	arbor
pisces	piscis
caelestibus	caelestis
nuceta	nucetus
praesumpsit	praesumo
operatur	operor
demiurgus	demiurgus
ignorans	ignoro
scit	scio
arbores	arbor
sola	solus
terra	terra
institui	instituo
oportere	oportet
mater	mater
sciebat	scio
suggerebat	suggero
effectum	effectus1
ministrabat	ministro
fastigium	fastigium
filio	filius
exstruens	exstruo
opera	opus?
patrem	pater
deum	deus
regem	rex
valentinianorum	Ualentiniani
ingenia	ingenium
testantur	testor
noluit	nolo
nota	nota
quaeram	quaero
tenendum	teneo
sophiam	sophia
cognominari	cognomino
terram	terra
matrem	mater
qussi	quis1
matrem	mater
terram	terra
rideas	rideo
spiritum	spiritus
sanctum	sanctus
honorem	honor
contulerunt	confero
feminae	femina
puto	puto
barbam	barba
alioquin	alioqui
demiurgus	demiurgus
compos	compos
animalibus	animal
censu	census
invalitudinis	inualitudo
spiritalia	spiritalis
accedere	accedo1
ratus	reor
contionaretur	contionor
deus	deus
absque	absque2
retro	retro1
sciebat	scio
intellegebat	intelligo
factitatorem	factitator
solus	solus
certus	certus
saltim	saltem
suspectus	suspectus2
factitatore	factitator
tolerabilior	tolerabilis
infamia	infamia
diabolum	diabolus
origo	origo
sordidior	sordidus
capit	capio2
nequitia	nequitia
maeroris	maeror
deputatur	deputo
angelorum	angelus
daemonum	daemon
spiritalium	spiritalis
malitiarum	malitia
genituras	gigno
notant	noto
diabolum	diabolus
opus	opus1
demiurgi	demiurgo
affirmant	affirmo
munditenentem	munditenens
appellant	appello1
superiorum	superus
gnarum	gnarus
defendunt	defendo
spiritalem	spiritalis
natura	natura
demiurgum	demiurgus
animalem	animalis
meretur	mereor
praelationem	praelatio
haereses	haeresis
procurantur	procuro
singularium	singularis
potestatum	potestas
arces	arx
finibus	finis
collocant	colloco
summis	superus
summitatibus	submitas
praesidet	praesideo
tricenarius	tricenarius
pleroma	pleroma
horo	horus
signante	signo
lineam	linea
extremam	exter
inferius	infra?
metatur	meto?
medietatem	medietas
achamoth	achamoth
filium	filius
calcans	calco
subest	subsum1
demiurgus	demiurgus
hebdomade	hebdoma
diabolus	diabolus
communi	communis
mundo	mundus1
coã	coa
«	«
lementato	lementato
concorporificato	concopporifico
editum	edo1
sophiae	sophia
utilissimis	utilis
casibus	casus
aã	ab
«	«
rem	res
reciprocandi	reciproco
spiritus	spiritus
spatium	spatium
teneram	tener
corporum	corpus
vestem	uestis
colorum	color
indicem	index
organum	organum
temporum	tempus1
sophiae	sophia
maestitia	maestitia
colasset	colo2
animalia	animal
metus	metus
conversio	conuersio
demiurgum	demiurgus
elementis	elementum
corporibus	corpus
ignis	ignis
inflabellatus	inflabello
originalem	originalis
sophiae	sophia
passionem	passio
ediderunt	edo1
argumentabor	argumentor
motiunculis	motiuncula
excussum	excutio
credas	credo
vexationibus	uexatio
febricitasse	febricito
deo	deus
diis	deus
homine	homo
figmenta	figmentum
molitus	molior
mundum	mundus1
demiurgus	demiurgus
hominem	homo
manus	manus1
confert	confero
substantiam	substantia
capit	capio2
arida	aridus
unicam	unicus
novimus	nosco
terra	terra
arida	aridus
postmodum	postmodum
aquis	aqua
segregatis	segrego
superstite	superstes
limo	limus1
siccaverit	sicco
invisibili	inuisibilis
corpore	corpus
materiae	materia
philosophicae	philosophicus
fluxili	fluxilis
fusili	fusilis
queo	queo
aestimare	aestimo
nusquam	nusquam
fusile	fusilis
fluxile	fluxilis
liquoris	liquor1
qualitas	qualitas
liquor	liquor1
sophiae	sophia
fletibus	fletus
fluxit	fluo
sequitur	sequor
limum	limus1
pituritis	pituritus
gramis	gramis
sophiae	sophia
constitisse	consisto
credamus	credo
lacrimarum	lacrima
faeces	faex
aquarum	aqua
desidet	desideo
limus	limus1
figulat	figulo
hominem	homo
demiurgus	demiurgus
afflatu	afflatus
animat	animo
choicus	choicus
animalis	animal
imaginem	imago
similitudinem	similitudo
quadruplex	quadruplex
imago	imago
choicus	choicus
deputetur	deputo
materialis	materialis
materia	materia
demiurgus	demiurgus
similitudo	similitudo
animalis	animal
demiurgus	demiurgus
duos	duo
carnalem	carnalis
superficiem	superficies
choico	choicus
supertextam	supertexo
pelliceam	pelliceus
tunicam	tunica
obnoxiam	obnoxius
sensui	sensus
inerat	insum1
achamoth	achamoth
substantia	substantia
sophiae	sophia
matris	mater
peculium	peculium
seminis	semen1
spiritalis	spiritalis
achamoth	achamoth
filio	filius
demiurgo	demiurgo
sequestraverat	sequestro2
guaro	guarus
accipe	accipio
industriam	industria
clandestinae	clandestinus
providentiae	prouidentia
deposuerat	depono
occultaverat	occulto
demiurgus	demiurgus
animam	anima
afflatu	afflatus
adam	adam
communicaret	communico
semen	semen1
spiritale	spiritalis
canalem	canalis1
anima	anima
derivaret	deriuo
choicum	choicus
feturatum	feturatus
corpore	corpus
materiali	materialis
utero	uterus
adultum	adultus
idoneum	idoneus
inveniretur	inuenio
suscipiendo	suscipio
quandoque	quandoque2
sermoni	sermo
perfecto	perficio
demiurgus	demiurgus
traducem	tradux
animae	anima
committit	committo
adam	adam
latuit	lateo
homo	homo
spiritalis	spiritalis
flatu	flatus
insertus	insero2
corpori	corpus
inductus	induco
semen	semen1
noverat	nosco
matris	mater
demiurgus	demiurgus
semen	semen1
ecclesiam	ecclesia
ecclesiae	ecclesia
supernae	supernus
speculum	speculum
hominis	homo
censum	census
achamoth	achamoth
deputantes	deputo
animalem	animalis
demiurgo	demiurgo
choicum	choicus
substantia	substantia
á	ab
¼	¼
	
ï	is
	
ï	is
	
á	ab
¿	¿
	
ï	is
	
carnem	caro1
materia	materia
novum	nouus
quadruplum	quadruplus
geryonem	geryo
exitum	exitus
singulis	singulus
dividunt	diuido
materiali	materialis
carnali	carnalis
sinistrum	sinister
vocant	uoco
indubitatum	indubitatus
interitum	interitus
animali	animal
dextrum	dexter
appellant	appello1
dubitatum	dubito
eventum	euentus
utpote	utpote
materialem	materialis
spiritalemque	spiritalis
{spiritalemque}	que
nutanti	nuto
illac	illac
debito	debitum
adnuerit	annuo
spiritalem	spiritalis
emitti	emitto
animalis	animal
comparationem	comparatio1
erudiri	erudio
exerceri	exerceo
conversationibus	conuersatio
indiguisse	indigeo
animalem	animalis
sensibilium	sensibilis
disciplinarum	disciplina
paraturam	paratura
mundi	mundus1
prospectam	prospicio
soterem	soter
mundo	mundus1
repraesentatum	repraesento
salutem	salus
animalis	animal
compositione	compositio
monstruosum	monstruosus
volunt	uolo3
prosicias	prosicio
substantiarum	substantia
induisse	induo
summam	summa
saluti	salus
redacturus	redigo
spiritalem	spiritalis
susceperit	suscipio
achamoth	achamoth
animalem	animalis
demiurgo	demiurgo
induit	induo
christum	christus
corporalem	corporalis
animali	animal
substantiam	substantia
miro	mirus
inenarrabili	inenarrabilis
rationis	ratio
ingenio	ingenium
constructam	construo
administrationis	administratio
congressui	congressus
conspectui	conspectus1
contactui	contactus
defunctui	defunctus
ingratis	ingratus
subiaceret	subiaceo
materiale	materialis
utpote	utpote
salutis	salus
alienum	alienus2
necessarius	necessarius1
egentibus	egens
salute	salus
totum	totus
carnis	caro1
alienando	alieno
christo	christus
spe	spes
salutis	salus
expellant	expello
reddo	reddo
christo	christus
licentia	licentia
iesum	iesus
inserunt	insero2
spiritale	spiritalis
semen	semen1
animali	animal
inflatu	inflatus2
infulciunt	infulcio
fartilia	fartilis
nescio	nescio
commenti	comminiscor
hominum	homo
deorum	deus
demiurge	demiurgo
christum	christus
filium	filius
naturalem	naturalis
animalem	animal
prolatum	profero
promulgatum	promulgo
prophetis	propheta
praepositionum	praepositio
quaestionibus	quaestio
positum	pono
virginem	uirgo
virgine	uirgo
editum	edo2
delatus	defero
virginem	uirgo
transmeatorio	transmeatorius
generatorio	generatorius
more	mos
processerit	procedo1
matrem	mater
viam	uia
passus	passus?
christum	christus
devolasse	deuolo2
baptismatis	baptisma
sacramento	sacramentum
iesum	Iesus
effigiem	effigies
columbae	columba
christo	christus
achamoth	achamoth
spiritalis	spiritalis
seminis	semen1
condimentum	condimentum
marcesceret	marcesco
reliqua	reliquus
farsura	farcura
figuram	figura
principalis	principalis
tetradis	tetradus
quatuor	quatuor
substantiis	substantia
stipant	stipo
spiritali	spiritalis
achamothiana	achamothianus
animali	animal
demiurgina	demiurginus
corporali	corporalis
inenarvativa	inenaruatiuus
sotericiana	sotericianus
columbina	columbinus
soter	soter
permensit	permetior
christo	christus
impassibilis	impassibilis
inlaesibilis	illaesibilis
inadprehensibilis	inapprehensibilis
adprehensiones	apprehensio
venitur	uenio
discessit	discedo1
cognitione	cognitio
pilati	pilatus
matris	mater
semen	semen1
admisit	admitto
iniurias	iniuria
aeque	aeque
insubditivum	insubditiuus
demiurgo	demiurgo
compertum	comperio
patitur	patior
animalis	animal
carneus	carneus
christus	christus
delineationem	delineatio
superioris	superus
christi	christus
achamoth	achamoth
formandam	formo
substantivali	substantiualis
agnitionali	agnitionalis
forma	forma
cruci	crux
horo	horus
innixus	innitor2
imagines	imago
urgent	urgeo
imaginarii	imaginarius
christiani	christianus1
interes	intersum1
demiurgus	demiurgus
nescins	nescins
prophetas	propheta
contionabitur	contionor
operis	opus1
intellegens	intelligens
dividunt	diuido
prophetiale	prophetialis
patrocinium	patrocinium
achamoth	achamoth
semen	semen1
demiurgum	demiurgus
adventum	aduentus
soteris	soto
accepit	accipio
propere	propere
ovanter	ouanter
accurrit	accurro
viribus	uis
centurio	centurio1
evangelie	euangelie
inluminatus	illumino
spem	spes
discit	disco
successurus	succedo1
locum	locus
matris	mater
exinde	exinde
securus	securus
dispensationem	dispensatio
mundi	mundus1
buius	buius
maxime	magis2
ecclesiae	ecclesia
protegendae	protego
nomine	nomen
tempore	tempus1
oportuerit	oportet
insequitur	insequor
colligam	colligo3
disperso	dispergo
concludendum	concludo
totius	totus
generis	genus1
humani	humanus
dispositione	dispositio
disserant	dissero2
triformem	triformis
naturam	natura
primordio	primordium
professi	profiteor
inunitam	inunio
adam	ada
dividunt	diuido
singulares	singularis
generum	genus?
proprietates	proprietas
nacti	nanciscor
occasionem	occasio
distinctionis	distinctio
huiusmdi	huiusmodi
posteritate	posteritas
adae	ada
moralibus	moralis
differentiis	differentia
tripartitae	tripartio
cain	caenum
abel	abel
seth	seth
fontes	fons
generis	genus1
humani	humanus
totidem	totidem2
derivant	deriuo
argumenta	argumentum
naturae	natura
essentiae	essentia
ghoicum	gonus
saluti	salus
degeneratum	degenero
cain	caenum
redigunt	redigo
animale	animalis
mediae	medius
spei	spes
deliberatum	delibero
abel	abel
componunt	compono
spiritale	spiritalis
certae	certus
saluti	salus
praeiudicatum	praeiudico
seth	sec
recondunt	recondo
animas	anima
duplici	duplex
proprietate	proprietas
discernunt	discerno
bonas	bonus
maias	maia
choicum	choicus
statum	status1
cain	cainus
animalem	animalis
abel	abel
spiritalem	spiritalis
seth	sec
obvenientia	obuenio
superducunt	superduco
naturam	natura
indulgentiam	indulgentia
achamoth	achamoth
superioribus	superus
animas	anima
bonas	bonus
depluat	depluo
animali	animal
censui	census
inscriptas	inscribo
choicum	choicus
genus	genus1
malas	malus3
animas	anima
nunquam	numquam
capere	capio2
salutaris	salutaris
inmutabilem	immutabilis1
inreformabilem	irreformabilis
naturae	natura
naturam	natura
pronuntiaverunt	pronuntio
granum	granum
seminis	semen1
spiritalis	spiritalis
modicum	modicus
parvulum	paruulus
iactu	iactus
eruditu	eruditus
fides	fides2
augetur	augeo
provehitur	proueho
animaeque	anima
{animaeque}	que
praevertunt	praeuerto
demiurgus	demiurgus
ignorans	ignoro
magni	magnus
laterculo	laterculus
reges	rex
sacerdotes	sacerdos
allegare	allego2
consueverat	consuesco
plenam	plenus
perfectam	perfectus2
notitiam	notitia
adprehenderint	apprehendo
naeniarum	nenia
naturificatae	naturifico
spiritalis	spiritalis
conditionis	conditio
germanitate	germanitas
certam	certus
obtinebunt	obtineo
salutem	salus
omnimodo	omnimodo
debitam	debeo
ideoque	ideo
{ideoque}	que
operationes	operatio
necessarias	necessarius2
existimant	existimo
disciplinae	disciplina
munia	munia
observant	obseruo
martyrii	martyrium
eludentes	eludo
necessitatem	necessitas
volunt	uolo3
interpretatione	interpretatio
regulam	regula
animali	animal
semini	semen1
praestitutam	praestituo
salutem	salus
privilegio	priuilegium
status	status1
possidemus	possideo
suffragio	suffragium
actus	ago
elaboremus	elaboro
inscriptura	inscriptura
buius	boius
seminis	semen1
imperfectae	imperfectus
essentiae	essentia
amoribus	amor
theleti	theletus
abortui	abortuus
deputamur	deputo
mater	mater
vae	uae
excesserimus	excedo1
disciplinae	disciplina
iugum	iugum
obtorpuerimus	obtorqueo
operibus	opus1
sanctitatis	sanctitas
iustitiae	iustitia
confitendum	confiteor
alibi	alibi
nescio	nescio
potestatibus	potestas
saeculi	saeculum
tribunalia	tribunal
praesidum	praesidus
optaverimus	opto
passivitate	passiuitas
vitae	uita
diligentia	diligentia
delictorum	delictum
generositatem	generositas
vindicent	uindico
blandiente	blandior
achamoth	achamoth
delinquendo	delinquo
profecit	proficio
honorandorum	honoro
coniugiorum	coniugium
supernorum	supernum
gratia	gratia
edicitur	edico2
meditandum	meditor
celebrandum	celebro
sacramentum	sacramentum
comiti	comes
feminae	femina
adhaerendo	adhaereo
alioquin	alioqui
degenerem	degener
legitimum	legitimus
veritatis	ueritas
deversatus	deuersor2
mundo	mundus1
amaverit	amo
feminam	femina
iunxerit	iungo
spadones	spado
superest	supersum1
consummatione	consummatio
dispensatione	dispensatio
mercedis	merces
achamoth	achamoth
totam	totus
messem	messis
seminis	semen1
perfecerit	perficio
colligere	colligo3
horreum	horreum
coeperit	coepio
molas	mola
delatum	defero
defarinatum	defarino
consparsionis	conspersio
alvearia	aluearium
absconderit	abscondo
totum	totus
confermentetur	confermento
consummatio	consummatio
urgebit	urgeo
inprimis	imprimis
achamoth	achamoth
regione	regio
medietatis	mediotas
tabulato	tabulatum
secundo	secundus1
summum	superus
transfertur	transfero
restituta	restituo
pleromati	pleromatus
excipit	excipio
compacticius	compacticius
soter	soter
sponsus	sponsus1
ambo	ambo2
coniugium	coniugium
novum	nouus
scripturis	scriptura
sponsus	sponsus1
sponsalis	sponsalis
pleroma	pleroma
credas	credo
loco	locus
locum	locus
transmigratur	transmigro
leges	lex
iulias	iulia
intervenire	interuenio
scenam	scena
demiurgus	demiurgus
hebdomade	hebdoma
caelesti	caelestis
superiora	superus
mutabit	muto2
vacuum	uacuus
coenaculum	coenaculum
matris	mater
sciens	scio
ignorare	ignoro
maluisset	malo
humana	humanus
gens	gens
exitus	exitus
ibit	eo1
choicae	choica
materialis	materialis
notae	nota
totum	totus
interit	intereo1
interitum	interitus
caro	caro1
foenum	foenum
anima	anima
mortalis	mortalis1
salutem	salus
fide	fides2
invenerit	inuenio
iustorum	iustus
animae	anima
demiurgum	demiurgus
medietatis	mediotas
receptacula	receptaculum
transmittentur	transmitto
agimus	ago
gratias	gratia
contenti	contentus1
deo	deus
deputari	deputo
census	census
animale	animalis
pleromatis	pleromo
palatium	palatium
admittitur	admitto
spiritale	spiritalis
examen	examen
valentini	Ualentinus
primo	primo
despoliantur	despolio
homines	homo
interiores	interior2
despoliari	despolio
deponere	depono
animas	anima
induti	induo
demiurgo	demiurgo
reddent	reddo
averterant	auerto
spiritus	spiritus
totum	totus
flent	fleo
intellectuales	intellectualis
detentui	detentus
conspectui	conspectus1
obnoxii	obnoxius
invisibiliter	inuisibiliter
pleroma	pleroma
recipientur	recipio
furtim	furtim
angelis	angelus
distribuentur	distribuo
satellitibus	satelles
soteris	soto
filios	filius
putas	puto
adparitores	apparitor
imagines	imago
utinam	utinam
pudet	pudeo
sponsas	sponsa
sabinas	sabina
raptas	rapio
iure	ius1
matrimonii	matrimonium
claudent	claudo1
spiritalium	spiritalis
merces	merces
praemium	praemium
credendi	credo
fabulae	fabula1
utiles	utilis
marcus	marcus
gaius	Gaius
carnem	caro1
barbatus	barbatus2
severus	seuerus
maritus	maritus1
pater	pater
avus	auus
proavus	proauus
sufficit	sufficio
masculus	masculus
nymphone	nymphon
pleromatis	pleromo
angelo	angelus
tacendo	taceo
parias	par2
onesimum	onesimus
aeonem	aeo
nuptiis	nuptiae
recte	recte
deducendis	deduco
flammeo	flammeum
credo	credo
ignis	ignis
arcanus	arcanus
erumpet	erumpo
universam	uniuersus
substantiam	substantia
depopulatus	depopulor
decineratis	decino
nihilum	nihilum
finietur	finio
fabula	fabula1
nae	nae
temerarius	temerarius
sacramentum	sacramentum
inludendo	illudo
prodiderim	prodo
verendum	uereor
achamoth	achamoth
filio	filius
agnitam	agnosco
voluit	uolo3
insaniat	insanio
theletus	theletus
irascatur	irascor
fortuna	fortuna
acerbetur	acerbo
homo	homo
demiurgi	demiurgo
illuc	illuc
devertere	deuerto
excessum	excessus
nubitur	nubo
superindui	superinduo
despoliari	despolio
despolior	despolio
sexui	sexuus
deputor	deputor
angelis	angelus
angelus	angelus
angela	angelus
masculum	masculus
invenient	inuenio
producam	produco
epicitharisma	epicitharisma
fabulam	fabula1
ordini	ordo
obstreperent	obstrepo
lectoris	lector
intentionem	intentio
interiectione	interiectio
dispargerent	dispargo
malui	malo
locum	locus
distulisse	differo
commendata	commendo
emendatoribus	emendator
ptolemaei	ptolemaeus
extiterunt	exsisto
schola	schola
discipuli	discipulus
magistrum	magister
duplex	duplex
coniugium	coniugium
bytho	bythus
adfingerent	affingo
cogitationem	cogitatio
voluntatem	uoluntas
una	unus
cogitatio	cogitatio
producere	produco
duabus	duo
facillimo	facilis
prolatu	prolatus
coniugium	coniugium
monogenem	monogenus
veritatem	ueritas
imaginem	imago
cogitationis	cogitatio
feminam	femina
veritatem	ueritas
imaginem	imago
voluntatis	uoluntas
marem	mas
monogenem	monogenus
voluntatis	uoluntas
vis	uis
effectum	efficio
praestat	praesto1
cogitationi	cogitatio
maris	mare
obtinet	obtineo
censum	census
pudiciores	pudicus
honorem	honor
divinitatis	diuinitas
recordati	recordor
unius	unus
coniugii	coniugium
dedecus	dedecus
avellerent	auello
maluerunt	malo
bytho	bythus
sexum	sexus
deputare	deputo
deum	deus
deus	deus
neutro	neuter
genere	genus1
pronuntiant	pronuntio
masculum	masculus
feminam	femina
solos	solus
lunenses	lunensis
hermaphroditum	hermaphroditus
existimet	existimo
annalium	annalis1
commentator	commentator
fenestella	fenestela
principatum	principatus
bytho	bythus
defendant	defendo
postumatum	postumatum
ogdoadem	ogdoades
praemittentes	praemitto
tetrade	tetrade
nominibus	nomen
derivatam	deriuo
primo	primo
constituunt	constituo
proarchen	proarche
secundo	secundus1
anennoã	anenno
«	«
ton	tondeo
tertio	tertius
arrheton	arrheton
quarto	quartus
aoraton	aoraton
proarche	proarche
processisse	procedo1
primo	primus
quinto	quintus
loco	locus
archen	arche
anennoã	anenno
«	«
to	tomo
secundo	secundus2
sexto	sextus
loco	locus
acatalepton	acatalepton
arrheto	arrhetus
tertio	tertius
septimo	septimus
loco	locus
anonomaston	anonomasto
invisibili	inuisibilis
quarto	quartus
octavo	octauus
loco	locus
agenneton	agenneto
ratio	ratio
disponat	dispono
singula	singulus
binis	binus
locis	locus
intercisis	intercido2
nascantur	nascor
malo	malum1
ignorare	ignoro
discere	disco
recti	rectum
perverse	peruerse
proferuntur	profero
meliores	bonus
totum	totus
taedium	taedium
medio	medius
amoliti	amoleo
aeonem	aeo
voluerunt	uolo3
gradus	gradus
revera	reuera
gemonios	gemonius
structum	struo
mappa	mappa
missa	mitto
octoiugem	octoiux
patre	pater
ennoea	ennoeus
exclusam	excludo
motu	motus
nomina	nomen
gerunt	gero
cogitavit	cogito
proferre	profero
pater	pater
protulit	profero
vera	uerum1
protulit	profero
veritas	ueritas
appellate	appello1
semetipsum	sui
{semetipsum}	ipse
voluit	uolo3
probari	probo
homo	homo
pronuntiatus	pronuntio
praecogitavit	praecogito
protulit	profero
ecclesia	ecclesia
nuncupata	nuncupo
sonuit	sono1
homo	homo
sermonem	sermo
primogenitus	primogenitus
filius	filius
sermoni	sermo
accessit	accedo1
vita	uita
ogdoas	ogdoa
prima	primus
conclusa	concludo
taedium	taedium
pusillum	pusillum1
accipe	accipio
ingonia	ingonia
circulatoria	circulatorius
insignioris	insignis
magistri	magister
pontificali	pontificalis
auctoritate	auctoritas
modum	modus
censuit	censeo
proarche	proarche
inexcogitabile	inexcogitabilis
inenarrabile	inenarrabilis
innominabile	innominabilis
nomino	nomino
monoteta	monotetus
virtus	uirtus
appello	appello1
henoteta	henotetum
monotes	mono
henotes	henos
solitas	solitus
unites	unites
unum	unus
protulerunt	profero
proferentes	profero
initium	initium
intellectuale	intellictualis
innascibile	innascibilis
invisibile	inuisibilis
sermo	sermo
monada	monadus
vocavit	uoco
adest	assum1
comsubstantiva	commubstantiuus
virtus	uirtus
appellat	appello1
unio	unius
virtutes	uirtus
solitas	solitus
singularitas	singularitas
unitas	unitas
unio	unium
prolationes	prolatio
aeonum	aeonus
propagarunt	propago2
o	o
differentia	differentia
mutetur	muto2
unio	unius
unitas	unitas
singularitas	singularitas
summa	summum1
solitas	solitus
designaveris	designo
unum	unus
humanior	humanus
secundus	secundus1
brevior	breuis
ogdoadem	ogdoado
duas	duo
tetradas	tetradus
dividens	diuido
dexteram	dextera
sinistram	sinistra1
lumen	lumen
tenebras	tenebrae
desultricem	desultrix
defetricem	defetrix
virtutem	uirtus
vult	uolo3
deducere	deduco
aeonum	aeonus
fructibus	fructus
substantia	substantia
venientibus	uenio
domino	dominus
iesu	Iesus
diversitas	diuersitas
scinditur	scindo
aeonum	aeonus
flosculis	flosculus
construunt	construo
solis	sol
decem	decem
constitisse	consisto
contendunt	contendo
sermo	sermo
vita	uita
protulerunt	profero
sermonis	sermo
vitae	uita
concurrerunt	concurro
tituli	titulus
duodecim	duodecim
hominis	homo
ecclesiae	ecclesia
fetu	fetus1
ideoque	ideo
{ideoque}	que
filium	filius
hominis	homo
pronuntiatum	pronuntio
christo	christus
spiritu	spiritus
sancto	sanctus
constabiliedae	constabilio
universitati	uniuersitas
provisis	prouideo
confictum	confingo
iure	ius1
paternae	paternus
appellationis	appellatio
haeredem	haereo
filium	filius
hominis	homo
aliunde	aliunde
conceperint	concipio
patrem	pater
magno	magnus
nominis	nomen
sacramento	sacramentum
hominem	homo
appellasse	appello1
praesumpserint	praesumo
amplius	ample
speres	spero
dei	deus
fide	fides2
adaequaris	adaequo
ingenia	ingenium
superfruticant	superfrutico
materni	maternus
seminis	semen1
redundantia	redundo
inolescentes	inolescens
doctrinae	doctrina
valentinianorum	Ualentiniani
silvas	silua
exoleverunt	exolesco
gnosticorum	gnosticus
varie	uarie
diabolus	diabolus
aemulatus	aemulor
veritatem	ueritas
adfectavit	affecto
defendendo	defendo
concutere	concutio
unicum	unicus
dominum	dominus
vindicat	uindico
omnipotentem	omnipotens
mundi	mundus1
conditorem	conditor1
unico	unicus
haeresim	haeresis
patrem	pater
descendisse	descendo
virginem	uirgo
natum	nascor
passum	passus1
iesum	Iesus
christum	christus
excidit	excido1
coluber	coluber
iesum	Iesus
christum	christus
baptisma	baptisma
ioannis	Ioannes
temptans	tento
filium	filius
dei	deus
adgressus	aggredior
certus	certus
filium	filius
deum	deus
scripturis	scriptura
temptationem	tentatio
struebat	struo
filius	filius
dei	deus
lapides	lapis
panes	panis
filius	filius
dei	deus
deice	deicio
scriptum	scribo
mandavit	mando2
angelis	angelus
pater	pater
manibus	manus1
tollant	tollo
necubi	necubi
lapidem	lapis
pedem	pes
offendas	offendo
numquid	numquid
mendacium	mendacium
evangeliis	euangelium
exprobravit	exprobro
matthaeus	mattaeus
lucas	luca
deum	deus
accessi	accedo1
omnipotentem	omnipotens
cominus	cominus
temptavi	tento
accessi	accedo1
temptavi	tento
filius	filius
dei	deus
nunquam	numquam
dignarer	dignor
primordio	primordium
mendax	mendax
hominem	homo
subornavit	suborno
praxean	praeeans
primus	primus
asia	asius
genus	genus1
perversitatis	peruersitas
intulit	infero
romam	roma
homo	homo
inquietus	inquietus
insuper	insuper1
iactatione	iactatio
martyrii	martyrium
inflatus	inflo
simplex	simplex
breve	breuis
carceris	carcer
taedium	taedium
corpus	corpus
tradidisset	trado
exurendum	exuro
profecisset	proficio
dilectionem	dilectio
dei	deus
charismata	charisma
expugnavit	expugno
episcopum	episcopus
romanum	Romanus
agnoscentem	agnosco
prophetias	prophetia
montani	montanus
priscae	priscus
maximillae	magimillus
agnitione	agnitio
pacem	pax
ecclesiis	ecclesia
asiae	asia
phrygiae	phrygia
inferentem	infero
falsa	falsus
prophetis	propheta
ecclesiis	ecclesia
adseverando	asseuero
praecessorum	praecessus
auctoritates	auctoritas
defendendo	defendo
coã	coa
«	«
git	gigo
litteras	littera
pacis	pax
revocare	reuoco
emissas	emitto
proposito	propositum
recipiendorum	recipio
charismatum	charisma
concessare	concesso
duo	duo
negotia	negotium
diaboli	diabolus
praxeas	praeeo1
romae	Roma
procuravit	procuro
prophetiam	prophetia
expulit	expello
haeresim	haeresis
intulit	infero
paracletum	paracletus
fugavit	fugo
patrem	pater
crucifixit	crucifigo
fruticaverant	fruticor
avenae	auena
praxeanae	praeeanus
superseminatae	supersemino
dormientibus	dormio
simplicitate	simplicitas
doctrinae	doctrina
traductae	traduco
dehinc	dehinc
deus	deus
voluit	uolo3
evulsae	euello
caverat	caueo
pristinum	pristinus
doctor	doctor
emendatione	emendatio
manet	maneo
chirographum	chirographum
psychicos	psychicus
gesta	gero
exinde	exinde
silentium	silentium
agnitio	agnitio
paracleti	paracletus
defensio	defensio
disiunxit	diiungo
psychicis	psychicus
avenae	auena
ubique	ubique
semen	semen1
excusserant	excutio
aliquamdiu	aliquamdiu
hypocrisin	hypocrisis
subdola	subdolus
vivacitate	uiuacitas
latitavit	latito1
denuo	denuo2
erupit	erumpo
denuo	denuo2
eradicabitur	eradico
voluerit	uolo3
dominus	dominus
commeatu	commeatus
die	dies
colligentur	colligo3
adulterae	adultera
fruges	frux
scandalis	scandalum
igni	ignis
inextinguibili	inexstinguibilis
cremabuntur	cremo
tempus	tempus1
pater	pater
natus	nascor
pater	pater
passus	patior
deus	deus
dominus	dominus
omnipotens	omnipotens
iesus	Iesus
christus	christus
praedicatur	praedico1
instructiores	instructus2
paracletum	paracletus
deductorem	deductor
veritatis	ueritas
unicum	unicus
deum	deus
credimus	credo
dispensatione	dispensatio
î	is
¿	¿
á	ab
¼	¼
°	°
îºî	Ious
¿	¿
î	is
½	½
î	is
¿	¿
î	is
¼	¼
á	ab
½	½
·	·
î	is
±	±
î	is
½	½
unici	unicus
dei	deus
filius	filius
sermo	sermo
processerit	procedo1
missum	mitto
patre	pater
virginem	uirgo
natum	nascor
hominem	homo
deum	deus
filium	filius
hominis	homo
filium	filius
dei	deus
cognominatum	cognomino
iesum	Iesus
christum	christus
passum	passus1
mortuum	mortuus?
sepultum	sepelio
scripturas	scriptura
resuscitatum	resuscito
patre	pater
caelo	caelum1
resumptum	resumo
sedere	sedeo
dexteram	dextera
patris	pater
venturum	uenio
iudicare	iudico
vivos	uiuus2
mortuos	mortuus1
exinde	exinde
miserit	mitto
promissionem	promissio
patre	pater
spiritum	spiritus
sanctum	sanctus
paracletum	paracletus
sanctificatorem	sanctificator
fidei	fides2
credunt	credo
patrem	pater
filium	filius
spiritum	spiritus
sanctum	sanctus
regulam	regula
initio	initium
evangelii	euangelium
decucurrisse	decurro
priores	prior
haereticos	haereticus
nedum	nedum1
praxean	praxea
hesternum	hesternus
probabit	probo
posteritas	posteritas
haereticorum	haereticus
novellitas	nouellitas
praxeae	praxea
hesterni	hesternus
peraeque	peraeque
universas	uniuersus
haereses	haeresis
praeiudicatum	praeiudico
verum	uerus
adulterum	adulter1
posterius	posterius
salva	saluus
praescriptione	praescriptio
ubique	ubique
instructionem	instructio
munitionem	munitio
quorundam	quidam
retractatibus	retractatus
locus	locus
unaquaeque	unusquisque
perversitas	peruersitas
examinata	examino
praeiudicata	praeiudico
damnari	damno
maxime	magis2
existimat	existimo
meram	merus
veritatem	ueritas
possidere	possideo
unicum	unicus
deum	deus
putat	puto
credendum	credo
patrem	pater
filium	filius
spiritum	spiritus
sanctum	sanctus
unus	unus
uno	unus
substantiae	substantia
unitatem	unitas
nihilominus	nihilominus
custodiatur	custodio
î	is
¿	¿
á	ab
¼	¼
°	°
îºî	Ious
¿	¿
î	is
½	½
î	is
¿	¿
î	is
¼	¼
á	ab
½	½
·	·
î	is
±	±
ï	is
	
sacramentum	sacramentum
unitatem	unitas
trinitatem	trinitas
disponit	dispono
tres	tres
dirigens	dirigo
patrem	pater
filium	filius
spiritum	spiritus
sanctum	sanctus
tres	tres
statu	status1
gradu	gradus
substantia	substantia
forma	forma
potestate	potestas
specie	species
unius	unus
substantiae	substantia
unius	unus
status	status1
unius	unus
potestatis	potestas
unus	unus
deus	deus
gradus	gradus
formae	forma
species	species
nomine	nomen
patris	pater
filii	filius
spiritus	spiritus
sancti	sanctus
deputantur	deputo
numerum	numerus
divisione	diuisio
patiuntur	patior
procedentes	procedo1
tractatus	tracto
demonstrabunt	demonstro
simplices	simplex
imprudentes	imprudens
idiotae	idiota
maior	magnus
credentium	credo
pars	pars
regula	regula
fidei	fides2
diis	deus
saeculi	saeculum
unicum	unicus
verum	uerum4
deum	deus
transfert	transfero
intellegentes	intelligo
unicum	unicus
î	is
¿	¿
á	ab
¼	¼
°	°
îºî	Iuppiter
¿	¿
î	is
½	½
î	eo1
¿	¿
î	eo1
¼	¼
á	ab
½	½
·	·
á	ab
¾	¾
³	³
credendum	credo
expavescunt	expauesco
î	eo1
¿	¿
á	ab
¼	¼
°	°
îºî	Iuppiter
¿	¿
î	eo1
½	½
î	eo1
¿	¿
î	eo1
¼	¼
á	ab
½	½
·	·
î	is
±	±
î	is
½	½
numerum	numerus
dispositionem	dispositio
trinitatis	trinitas
divisionem	diuisio
praesumunt	praesumo
unitatis	unitas
unitas	unitas
semetipsa	sui
{semetipsa}	ipse
derivans	deriuo
trinitatem	trinitas
destruatur	destruo
administretur	administro
duos	duo
tres	tres
iactitant	iactito
praedicari	praedico1
unius	unus
dei	deus
cultores	cultor
praesumunt	praesumo
unitas	unitas
inrationaliter	irrationaliter
collecta	colligo3
haeresim	haeresis
trinitas	trinitas
rationaliter	rationaliter
expensa	expendo
veritatem	ueritas
constituat	constituo
monarchiam	monarchium
tenemus	teneo
sonum	sonus
vocaliter	uocaliter
exprimunt	exprimo
latini	latinum
modifice	modifice
putes	puto
bene	bene
intellegere	intelligo
monarchiam	monarchium
enuntiant	enuntio
monarchiam	monarchium
sonare	sono1
student	studeo
latini	Latinus
î	eo1
¿	¿
á	ab
¼	¼
°	°
îºî	Iuppiter
¿	¿
î	eo1
½	½
î	eo1
¿	¿
î	eo1
¼	¼
á	ab
½	½
·	·
î	is
±	±
î	eo1
½	½
intellegere	intelligo
nolunt	nolo
graeci	Graeci
utriusque	uterque
linguae	lingua
praecerpsi	praecerpo
monarchiam	monarchium
significare	significo
scio	scio
singulare	singularis
unicum	unicus
imperium	imperium
praescribere	praescribo
monarchiam	monarchium
unius	unus
filium	filius
filium	filius
monarchiam	monarchium
velit	uolo3
administrare	administro
atquin	atqui
dominationem	dominatio
unius	unus
singularem	singularis
monarchiam	monarchium
proximas	propior
personas	persona
administretur	administro
prospexerit	prospicio
officiales	officialis
filius	filius
monarchia	monarchium
dividi	diuido
monarchiam	monarchium
desinere	desino
particeps	particeps1
adsumatur	assumo
filius	filius
principaliter	principaliter
communicatur	communico
filium	filius
monarchiam	monarchium
duobus	duo
unicis	unicus
continetur	contineo
monarchia	monarchium
divina	diuinus2
legiones	legio
exercitus	exercitus1
angelorum	angelus
administratur	administro
scriptum	scribo
milies	milliens
centies	centies
centena	centenus
milia	mille
adsistebant	assisto
milies	milliens
centena	centenus
milia	mille
apparebant	appareo
unius	unus
desiti	desino
desinat	desino
monarchia	monarchium
milia	mille
virtutum	uirtus
procuratur	procuro
deus	deus
divisionem	diuisio
dispersionem	dispersio
pati	patior
filio	filius
spiritu	spiritus
sancto	sanctus
tertium	tertius
sortitis	sortior
locum	locus
consortibus	consors
substantiae	substantia
patris	pater
patitur	patior
angelorum	angelus
numero	numerus
ecquid	ecquid
nata	nascor
substantia	substantia
patris	pater
membra	membrum
pignora	pignus
instrumenta	instrumentum
vim	uis
totum	totus
censum	census
monarchiae	monarchium
eversionem	euersio
deputas	deputo
recte	recte
malo	malum3
sensum	sensus
sonum	sonus
vocabuli	uocabulum
exerceas	exerceo
eversio	euersio
monarchiae	monarchium
intellegenda	intelligo
dominatio	dominatio
condicionis	condicio
proprii	proprius
status	status1
aemula	aemula
superducitur	superduco
deus	deus
infertur	infero
creatorem	creator
marcione	marcio
valentinos	Ualentini
prodicos	prodicus
monarchiae	monarchium
eversionem	euersio
creatoris	creator
destructionem	destructio
filium	filius
aliunde	aliunde
deduco	deduco
substantia	substantia
patris	pater
patris	pater
voluntate	uoluntas
patre	pater
consecutum	consequor
potestatem	potestas
fide	fides2
destruere	destruo
monarchiam	monarchium
patre	pater
filio	filius
traditam	trado
filio	filius
servo	seruus1
tertium	tertius
gradum	gradus
spiritum	spiritus
aliunde	aliunde
puto	puto
patre	pater
filium	filius
monarchiam	monarchium
destruas	destruo
dispositionem	dispositio
dispensationem	dispensatio
evertis	euerto
nominibus	nomen
constitutam	constituo
deus	deus
voluit	uolo3
manet	maneo
statu	status1
trinitas	trinitas
inferatur	infero
restitui	restituo
patri	pater
filio	filius
siquidem	siquidem
apostolus	apostolus
scribit	scribo
ultimo	ultimus
fine	finis
tradiderit	trado
regnum	regnum
deo	deus
patri	pater
oportet	oportet
regnare	regno
ponat	pono
inimicos	inimicus2
deus	deus
pedes	pes
psalmum	psalmus
sede	sedes
dexteram	dextera
ponam	pono
inimicos	inimicus1
scabellum	scabellum
pedum	pes
subiecta	subicio
absque	absque2
subiecit	subicio
subicietur	subicio
subiecit	subicio
deus	deus
obesse	obsum1
monarchiae	monarchium
filium	filius
filium	filius
statu	status1
filium	filius
statu	status1
restituetur	restituo
patri	pater
filio	filius
nomine	nomen
destruet	destruo
filium	filius
admittat	admitto
traditam	trado
patre	pater
quandoque	quandoque2
restituendam	restituo
patri	pater
constat	consto
uno	unus
capitulo	capitulum
epistulae	epistola
spostolicae	spostolicus
patrem	pater
filium	filius
ostendisse	ostendo
duos	duo
praeterquam	praeterquam
nominibus	nomen
patris	pater
filii	filius
tradidit	trado
regnum	regnum
tradidit	trado
subiecit	subicio
subiecit	subicio
duo	duo
necesse	necesse
duos	duo
unum	unus
volunt	uolo3
pater	pater
filius	filius
oportet	oportet
totum	totus
filio	filius
examinari	examino
formam	forma
scripturis	scriptura
interpretationibus	interpretatio
patrocinantibus	patrocinor
vindicabit	uindico
genesim	genesis
hebraico	Hebraicus
incipere	incipio
principio	principium
deus	deus
filium	filius
firmum	firmus
argumenta	argumentum
deducunt	deduco
dei	deus
dispositione	dispositio
mundi	mundus1
constitutionem	constitutio
filii	filius
generationem	generatio
deus	deus
solus	solus
mundus	mundus1
locus	locus
solus	solus
extrinsecus	extrinsecus
solus	solus
semetipso	sui
{semetipso}	ipse
rationem	ratio
rationalis	rationalis2
deus	deus
ratio	ratio
ratio	ratio
sensus	sensus
graeci	Graeci
î	eo1
»	»
á	ab
½	½
¹	¹
î	is
³	³
î	is
¿	¿
î	is
½	½
vocabulo	uocabulum
sermonem	sermo
appellamus	appello1
ideoque	ideo
{ideoque}	que
usu	usus
simplicitatem	simplicitas
interpretationis	interpretatio
sermonem	sermo
primordio	primordium
deum	deus
rationem	ratio
competat	competo
antiquiorem	antiquus
sermonalis	sermonalis
principio	principium
rationalis	rationalis2
deus	deus
principium	principium
sermo	sermo
ratione	ratio
consistens	consisto
priorem	prior
substantiam	substantia
ostendat	ostendo
interest	intersum1
deus	deus
sermonem	sermo
miserat	mitto
ratione	ratio
semetipsum	sui
{semetipsum}	ipse
tacite	tacite
cogitando	cogito
disponendo	dispono
sermonem	sermo
ratione	ratio
cogitans	cogito
disponens	dispono
sermonem	sermo
efficiebat	efficio
sermone	sermo
tractabat	tracto
facilius	facile
intellegas	intelligo
recognosce	recognosco
imagine	imago
similitudine	similitudo
dei	deus
temetipso	tenetipio
rationem	ratio
animal	animal
rationale	rationalis2
rationali	rationalis2
artifice	artifex
substantia	substantia
animatus	animatus
tacitus	tacitus
congrederis	congredior
ratione	ratio
agi	ago
occurrente	occurro
sermone	sermo
cogitatus	cogito
motum	motus
sensus	sensus
pulsum	pulsus
cogitaveris	cogito
sermo	sermo
senseris	sentio
ratio	ratio
loquaris	loquor
animo	animus
necesse	necesse
loqueris	loquor
conlocutorem	collocutor
pateris	patior
sermonem	sermo
inest	insum1
ratio	ratio
cogitans	cogito
loquaris	loquor
loquens	loquor
cogitas	cogito
secundus	secundus2
sermo	sermo
loqueris	loquor
cogitando	cogito
cogitas	cogito
loquendo	loquor
sermo	sermo
plenius	plene
agitur	ago
deo	deus
imago	imago
similitudo	similitudo
censeris	censeo
tacendo	taceo
rationem	ratio
ratione	ratio
sermonem	sermo
temere	temere
praestruxisse	praestruo
deum	deus
universitatis	uniuersitas
constitutionem	constitutio
semetipso	sui
{semetipso}	ipse
rationem	ratio
ratione	ratio
sermonem	sermo
secumdum	secumdus
agitando	agito
vis	uis
divini	diuinus2
sensus	sensus
dispositio	dispositio
scripturas	scriptura
sophiae	sophia
nomine	nomen
ostenditur	ostendo
sapientius	sapiens2
ratione	ratio
dei	deus
sermone	sermo
sophiam	sophia
exaudi	exaudio
secundam	secundus1
personam	persona
conditam	condo
primo	primo
dominus	dominus
creavit	creo
initium	initium
viarum	uia
opera	opus?
terram	terra
montes	mons
collocarentur	colloco
colles	collis
genervit	generesco
sensu	sensus
condens	condo
generans	genero
dehinc	dehinc
adsistentem	assisto
separatione	separatio
cognosce	cognosco
pararet	paro2
caelum	caelum1
aderam	assum1
fortia	fortis
ventos	uentus
sursum	sursum
nubila	nubila
tutos	tutus
ponebat	pono
fontes	fons
caelo	caelum1
compingens	compingo1
gaudebat	gaudeo
cottidie	cotidie
oblectabar	oblecto
persona	persona
deus	deus
voluit	uolo?
sophiae	sophia
ratione	ratio
sermone	sermo
disposuerat	dispono
substantias	substantia
species	species
edere	edo1
protulit	profero
sermonem	sermo
individuas	indiuiduus
rationem	ratio
sophiam	sophia
universa	uniuersus
cogitata	cogito
disposita	dispono
dei	deus
sensu	sensus
deerat	desum1
speciebus	species
substantiis	substantia
cognoscerentur	cognosco
tenerentur	teneo
sermo	sermo
speciem	species
ornatum	ornatus2
sumit	sumo
sonum	sonus
vocem	uox
deus	deus
lux	lux
nativitas	natiuitas
perfecta	perficio
sermonis	sermo
deo	deus
procedit	procedo1
conditus	condo
cogitatum	cogito
nomine	nomen
sophiae	sophia
dominus	dominus
condidit	condo
initium	initium
viarum	uia
dehinc	dehinc
generatus	genero
effectum	effectus1
pararet	paro2
caelum	caelum1
aderam	assum1
exinde	exinde
parem	par2
procedendo	procedo1
filius	filius
primogenitus	primogenitus
genitus	gigno
unigenitus	unigenitus
solus	solus
deo	deus
genitus	gigno
proprie	proprie
vulva	uulua
cordis	cor
pater	pater
testatur	testor
eructavit	eructo
cor	cor
sermonem	sermo
optimum	bonus
deinceps	deinceps
gaudens	gaudeo
gaudentem	gaudeo
persona	persona
filius	filius
genui	gigno
luciferum	lucifer2
genui	gigno
filius	filius
persona	persona
profitetur	profiteor
patrem	pater
nomine	nomen
sophiae	sophia
dominus	dominus
condidit	condo
initium	initium
viarum	uia
opera	opus?
colles	collis
generavit	genero
sophia	sophis
conditam	condo
domino	dominus
opera	opus?
vias	uia
alibi	alibi
sermonem	sermo
ostenditur	ostendo
sermone	sermo
caeli	caelum1
confirmati	confirmo
spiritu	spiritus
vires	uis
spiritu	spiritus
sermoni	sermo
inerat	insum1
apparet	appareo
unam	unus
vim	uis
nomine	nomen
sophiae	sophia
appellatione	appellatio
sermonis	sermo
initium	initium
accepit	accipio
viarum	uia
dei	deus
opera	opus1
caelum	caelum1
confirmavit	confirmo
diutius	diu
sermo	sermo
sophiae	sophia
rationis	ratio
divini	diuinus2
animi	animus
spiritus	spiritus
nomine	nomen
filius	filius
dei	deus
prodeundo	prodeo1
generatus	genero
substantiam	substantia
sermonem	sermo
spiritu	spiritus
sophiae	sophia
traditione	traditio
constructam	construo
vis	uis
substantivum	substantiuus
substantiae	substantia
proprietatem	proprietas
persona	persona
capiat	capio2
secundus	secundus1
deo	deus
constitutus	constituo
duos	duo
efficere	efficio
patrem	pater
filium	filius
deum	deus
sermonem	sermo
sermo	sermo
vox	uox
sonus	sonus
oris	os1
grammatici	grammaticus1
tradunt	trado
aer	aer
offensus	offendo
intellegibilis	intelligibilis
auditu	auditus
vacuum	uacuus
nescio	nescio
inane	inanis
incorporale	incorporalis
deo	deus
inane	inanis
vacuum	uacuus
prodire	prodeo1
inani	inanis
vacuo	uacuus
prolatum	profero
carere	careo
substantia	substantia
substantia	substantia
processit	procedo1
substantias	substantia
inanis	inanis
solida	solidus2
vacuus	uacuus
plena	plenus
incorporalis	incorporalis
corporalia	corporalis
operatus	operor
fleri	fleo
diversum	diuersus
vacuum	uacuus
inane	inanis
vacua	uacuus
inanis	inanis
sermo	sermo
dei	deus
filius	filius
deus	deus
cognominatus	cognomino
sermo	sermo
deum	deus
deus	deus
sermo	sermo
scriptum	scribo
sumes	sumo
nomen	nomen
dei	deus
vanum	uanus
effigie	effigies
dei	deus
constitutus	constituo
rapinam	rapina1
existimavit	existimo
s	semis1
aequalem	aequalis2
deo	deus
effigie	effigies
dei	deus
negabit	nego
deum	deus
corpus	corpus
deus	deus
spiritus	spiritus
spiritus	spiritus
corpus	corpus
generis	genus1
effigie	effigies
invisibilia	inuisibilis
deum	deus
corpus	corpus
formam	forma
soli	solus
deo	deus
visibilia	uisibilis
substantia	substantia
emissum	emitto
substantia	substantia
substantia	substantia
sermonis	sermo
personam	persona
nomen	nomen
filii	filius
vindico	uindico
filium	filius
ag	ag
patre	pater
defendo	defendo
ai	aio
putaverit	puto
ï	eo1
	
ï	eo1
	
î	eo1
¿	¿
î	eo1
²	²
î	eo1
¿	¿
î	eo1
»	»
á	ah
½	½
´	´
î	eo1
½	½
introducere	introduco
prolationem	prolatio
valentinus	Ualentinus
aeonem	aeo
aeone	aeo
{aeone}	ne2
producens	produco
primo	primus
utatur	utor
veritas	ueritas
vocabulo	uocabulum
censu	census
haeresis	haeresis
utitur	utor
haeresis	haeresis
veritate	ueritas
accepit	accipio
mendacium	mendacium
strueret	struo
prolatus	profero
sermo	sermo
dei	deus
gradum	gradus
fige	figo
prolatus	profero
cognosce	cognosco
ï	eo1
	
ï	eo1
	
î	eo1
¿	¿
î	eo1
²	²
î	eo1
¿	¿
î	eo1
»	»
á	ab
¿	¿
	
î	is
½	½
veritatis	ueritas
haeresis	haeresis
veritate	ueritas
imitata	imitor
quaeritur	quaero
utatur	utor
vocabulo	uocabulum
valentinus	Ualentinus
ï	eo1
	
ï	eo1
	
î	eo1
¿	¿
î	eo1
²	²
î	eo1
¿	¿
î	eo1
»	»
á	ah
½	½
°	°
ï	is
	
discernit	discerno
separat	separo2
auctore	auctor
longe	longe
ponit	pono
aeon	aeon
patrem	pater
nesciat	nescio
desiderat	desidero
nosse	nosco
devoratur	deuoro
dissolvitur	dissoluo
reliquam	reliquus
substantiam	substantia
solus	solus
filius	filius
patrem	pater
novit	nosco
sinum	sinus
patris	pater
exposuit	expono
patrem	pater
audivit	audio
mandatus	mandatus
patre	pater
loquitur	loquor
patris	pater
perfecit	perficio
voluntatem	uoluntas
proximo	propior
initio	initium
noverat	nosco
scit	scio
deo	deus
spiritus	spiritus
sermo	sermo
spiritu	spiritus
structus	struo
sermonis	sermo
corpus	corpus
spiritus	spiritus
sermo	sermo
patre	pater
patre	pater
deum	deus
scriptum	scribo
sermo	sermo
deum	deus
nunquam	numquam
separatus	separatus2
patre	pater
patre	pater
pater	pater
unum	unus
ï	eo1
	
ï	eo1
	
î	eo1
¿	¿
î	eo1
²	²
î	eo1
¿	¿
î	eo1
»	»
á	ab
½	½
´	´
veritatis	ueritas
custos	custos
unitatis	unitas
prolatum	profero
filium	filius
patre	pater
separatum	separo2
protulit	profero
deus	deus
sermonem	sermo
paracletus	paracletus
docet	doceo
radix	radix
fruticem	frutex
fons	fons
fluvium	fluuius
sol	sol
radium	radius
species	species
ï	eo1
	
ï	eo1
	
î	eo1
¿	¿
î	eo1
²	²
î	eo1
¿	¿
î	eo1
»	»
î	eo1
±	±
á	ab
½	½
¶	¶
substantiarum	substantia
prodeunt	prodeo1
dubitaverim	dubito
filium	filius
radicis	radix
fruticem	frutex
fontis	fons
fluvium	fluuius
solis	sol
radium	radius
origo	origo
parens	parens1
origine	origo
profertur	profero
progenies	progenies
sermo	sermo
dei	deus
proprie	proprie
nomen	nomen
filii	filius
accepit	accipio
frutex	frutex
radice	radix
fluvius	fluuius
fonte	fons
radius	radius
sole	sol
discernitur	discerno
deo	deus
sermo	sermo
exemplorum	exemplum
formam	forma
profiteor	profiteor
duos	duo
deum	deus
sermonem	sermo
patrem	pater
filium	filius
radix	radix
frutex	frutex
duae	duo
coniunctae	coniungo
fons	fons
flumen	flumen
duae	duo
species	species
indivisae	indiuisus
sol	sol
radius	radius
duae	duo
formae	forma
cohaerentes	cohaereo
prodit	prodeo1
necesse	necesse
prodit	prodeo1
soparatum	soparo
secundus	secundus2
duo	duo
tertius	tertius
tres	tres
tertius	tertius
spiritus	spiritus
deo	deus
filio	filius
tertius	tertius
radice	radix
fructus	fructus
frutice	frutex
tertius	tertius
fonte	fons
rivus	riuus
flumine	flumen
tertius	tertius
sole	sol
apex	apex
radio	radius
matrice	matrix
alienatur	alieno
proprietates	proprietas
ducit	duco
trinitas	trinitas
consertos	consero2
connexos	connecto
gradus	gradus
patre	pater
decurrens	decurro
monarchiae	monarchium
obstrepit	obstrepo
î	eo1
¿	¿
á	ab
¼	¼
°	°
îºî	Ious
¿	¿
î	eo1
½	½
î	eo1
¿	¿
î	eo1
¼	¼
á	ab
½	½
·	·
î	is
±	±
ï	eo1
	
statum	status1
protegit	protego
regulam	regula
professum	profiteor
inseparatos	inseparatus
alterutro	alteruter
patrem	pater
filium	filius
spiritum	spiritus
testor	testor
tene	tu
{tene}	ne2
ubique	ubique
agnosces	agnosco
patrem	pater
filium	filius
spiritum	spiritus
male	male
accepit	accipio
idiotes	idiotes
perversus	peruersus
diversitatem	diuersitas
sonet	sono1
diversitate	diuersitas
separationem	separatio
protendat	protendo
patris	pater
filii	filius
spiritus	spiritus
necessitate	necessitas
patrem	pater
filium	filius
spiritum	spiritus
contendunt	contendo
î	eo1
¿	¿
á	ab
¼	¼
°	°
îºî	Iuppiter
¿	¿
î	eo1
½	½
î	eo1
¿	¿
î	eo1
¼	¼
á	ab
½	½
·	·
î	is
±	±
î	eo1
½	½
monarchiae	monarchium
adulantes	adulor
diversitate	diuersitas
filium	filius
patre	pater
distributione	distributio
divisione	diuisio
distinctione	distinctio
pater	pater
filius	filius
modulo	modulus
pater	pater
tota	totus
substantia	substantia
filius	filius
derivatio	deriuatio
totius	totus
portio	portio
profitetur	profiteor
pater	pater
maior	magnus
minoratus	minoro
canitur	cano
psalmo	psalmus
modicum	modicus
citra	citra2
angelos	angelus
pater	pater
filio	filius
filio	filius
maior	magnus
generat	genero
generatur	genero
mittit	mitto
mittitur	mitto
bene	bene
dominus	dominus
usus	utor
verbo	uerbum
persona	persona
paracleti	paracletus
divisionem	diuisio
significavit	significo
dispositionem	dispositio
rogabo	rogo
patrem	pater
advocatum	aduocatus
mittet	mitto
spiritum	spiritus
veritatis	ueritas
paracletum	paracletus
patre	pater
filium	filius
tertium	tertius
gradum	gradus
ostenderet	ostendo
paracleto	paracletus
filio	filius
î	is
¿	¿
á	ab
¼	¼
°	°
îºî	Ious
¿	¿
î	eo1
½	½
î	is
¿	¿
î	is
¼	¼
á	ab
½	½
·	·
î	is
±	±
ï	is
	
observationem	obseruatio
pater	pater
filius	filius
vocantur	uoco
vocabuntur	uoco
permiscere	permisceo
diversitas	diuersitas
vocabulorum	uocabulum
vocabula	uocabulum
amplius	ample
malo	malus3
pater	pater
filius	filius
dies	dies
nox	nox
pater	pater
filius	filius
ambo	ambo2
unus	unus
vanissimi	uanus
monarchiani	monarchianus
volunt	uolo3
filium	filius
atquin	atqui
pater	pater
filium	filius
patrem	pater
filius	filius
alterutro	alteruter
semetipsis	sui
{semetipsis}	ipse
pater	pater
filium	filius
filius	filius
patrem	pater
praestet	praesto1
instituit	instituo
deus	deus
custodit	custodio
necesse	necesse
pater	pater
filium	filius
pater	pater
filius	filius
patrem	pater
filius	filius
verbi	uerbum
gratia	gratia
maritus	maritus1
oportet	oportet
uxorem	uxor
uxor	uxor
pater	pater
filium	filius
filius	filius
filius	filius
patrem	pater
pater	pater
pater	pater
filium	filius
filius	filius
patrem	pater
porro	porro
patrem	pater
pater	pater
filium	filius
filius	filius
oportet	oportet
filius	filius
pater	pater
filium	filius
filius	filius
filium	filius
filius	filius
pater	pater
filium	filius
debeo	debeo
pater	pater
filius	filius
patrem	pater
filium	filius
aeque	aeque
pater	pater
filius	filius
patrem	pater
pater	pater
patrem	pater
pater	pater
filius	filius
patrem	pater
debeo	debeo
filius	filius
pater	pater
filium	filius
patrem	pater
totum	totus
ingenium	ingenium
diaboli	diabolus
excludere	excludo
unum	unus
monarchiae	monarchium
favore	fauor
concludens	concludo
neutrum	neuter
pater	pater
filium	filius
filius	filius
aeque	aeque
patrem	pater
pater	pater
filius	filius
monarchiam	monarchium
tenent	teneo
patrem	pater
filium	filius
continent	contineo
deo	deus
difficile	difficilis
nesciat	nescio
impossibilia	impossibilis
saeculum	saeculum
possibilia	possibilis
deum	deus
ignoret	ignoro
stulta	stultus
mundi	mundus1
elegit	eligo3
deus	deus
confundat	confundo2
sapientia	sapientia
legimus	lego2
difficile	difficilis
deo	deus
patrem	pater
filium	filius
traditam	trado
formam	forma
humanis	humanus
sterilem	sterilis
parere	pareo
naturam	natura
difficile	difficilis
deo	deus
virginem	uirgo
deo	deus
difficile	difficilis
abrupte	abruptus
praesumptionibus	praesumptio
sententia	sententia
utamur	utor
deo	deus
confingere	confingo
credendum	credo
requirendum	requiro
voluisset	uolo3
deus	deus
pennis	penna
hominem	homo
volandum	uolo2
instruxisse	instruo
milvis	milua
praestitit	praesto1
praxean	praxea
haereticos	haereticus
extinxisse	exstinguo
extinxit	exstinguo
oportebat	oportet
milvos	miluus
haereticos	haereticus
oportebat	oportet
patrem	pater
crucifigi	crucifigo
ratione	ratio
difficile	difficilis
deo	deus
noluerit	nolo
dei	deus
velle	uolo3
nolle	nolo
voluit	uolo3
ostendit	ostendo
voluit	uolo3
semetipsum	sui
{semetipsum}	ipse
filium	filius
probabis	probo
voluisse	uolo3
probaveris	probo
probare	probo
aperte	aperte
debebis	debeo
scripturis	scriptura
probamus	probo
filium	filius
sermonem	sermo
filium	filius
nominat	nomino
filius	filius
prodiit	prodeo1
sermo	sermo
prodiit	prodeo1
ertifilius	ertifilis
prodiit	prodeo1
prodiit	prodeo1
semetipso	sui
{semetipso}	ipse
porro	porro
patrem	pater
lilium	lilium
protulisse	profero
semetipso	sui
{semetipso}	ipse
prodisse	prodeo1
deus	deus
exhibe	exhibeo
probationem	probatio
expostulo	expostulus
similem	similis
scripturas	scriptura
filium	filius
patrem	pater
ostendere	ostendo
quamadmodum	quamadmodum
distincte	distincte
pater	pater
filius	filius
demonstrantur	demonstro
distincte	distincte
divise	diuido
profero	profero
deo	deus
eructavit	eructo
cor	cor
sermonem	sermo
optimum	bonus
aeque	aeque
opponas	oppono
alicubi	alicubi
deum	deus
eructavit	eructo
cor	cor
sermonem	sermo
optimum	bonus
eructavit	eructo
eructavit	eructo
protulerit	profero
prolatus	profero
sermo	sermo
deus	deus
propono	propono
patrem	pater
filio	filius
filius	filius
generavi	genero
velis	uolo3
credam	credo
patrem	pater
filium	filius
ostende	ostendo
pronumtiatum	pronustio
alibi	alibi
dominus	dominus
filius	filius
generavi	genero
luciferum	lucifer2
generavi	genero
dominus	dominus
condidi	condo
initium	initium
viarum	uia
opera	opus?
colles	collis
generavi	genero
modum	modus
verebatur	uereor
deus	deus
dominus	dominus
universitatis	uniuersitas
pronuntiare	pronuntio
verebatur	uereor
crederetur	credo
simpliciter	simpliciter
patrem	pater
filium	filius
pronuntiasset	pronuntio
unum	unus
veritus	uereor
mentiri	mentior
veritus	uereor
semetipsum	sui
{semetipsum}	ipse
veritatem	ueritas
veracem	uerax
deum	deus
credens	credo
scio	scio
disposuit	dispono
pronuntiasse	pronuntio
disposuisse	dispono
pronuntiavit	pronuntio
porro	porro
mendacem	mendax
efficias	efficio
fallacem	fallax
deceptorem	deceptor
fidei	fides2
filius	filius
filii	filius
personam	persona
scripturae	scriptura
demonstrationem	demonstratio
distinctionem	distinctio
trinitatis	trinitas
ostendant	ostendo
praescriptio	praescriptio
deducitur	deduco
unum	unus
loquitur	loquor
loquitur	loquor
loquitur	loquor
perversitas	peruersitas
fallacia	fallacia
deo	deus
congruat	congruo
loquebatur	loquor
semetipsum	sui
{semetipsum}	ipse
loquatur	loquor
accipe	accipio
voces	uox
patris	pater
filio	filius
esaiam	Esaias
filius	filius
elegi	eligo3
dilectus	dilectus1
bene	bene
sensi	sentio
ponam	pono
spiritum	spiritus
iudicium	iudicium
nationibus	natio1
annuntiabit	annuncio
accipe	accipio
magnum	magnus
voceris	uoco
filius	filius
statuendas	statuo
tribus	tres
iacob	iacor
convertendam	conuerto
dispersionem	dispersio
israelis	israel
posui	pono
lucem	lux
natinum	natinus
salus	salus
extremum	exter
terrae	terra
accipe	accipio
filii	filius
voces	uox
patre	pater
spiritus	spiritus
domini	dominus
quapropter	quapropter1
unxit	ungo
evangelizandum	euangelizo
hominibus	homo
psalmo	psalmus
patrem	pater
dereliqueris	derelinquo
annuntiem	annuntio
brachium	brachium
nativitati	natiuitas
universae	uniuersus
venturae	uenio
domine	dominus
multiplicati	multiplico
comprimunt	comprimo
psalmi	psalmus
christi	christus
personam	persona
sustinent	sustineo
filium	filius
patrem	pater
christum	christus
deum	deus
verba	uerbum
repraesentant	repraesento
animadverte	animaduerto
spiritum	spiritus
loquentem	loquor
tertia	tertius
persona	persona
patre	pater
filio	filius
dominus	dominus
domino	dominus
sede	sedes
dexteram	dextera
ponam	pono
inimicos	inimicus1
scabellum	scabellum
pedum	pes
esaiam	esaiam
dominus	dominus
domino	dominus
christo	christus
patrem	pater
filio	filius
domine	dominus
credidit	credo
auditui	auditus
brachium	brachium
domini	dominus
revelatum	reuelo
annuntiavimus	annuncio
puerulus	puerulus
radix	radix
terra	terra
sitienti	sitio
forma	forma
gloria	gloria
pauca	paucus
affectamus	affecto
universas	uniuersus
scripturas	scriptura
evolvere	euoluo
singulis	singulus
capitulis	capitulum
plenam	plenus
maiestatem	maiestas
auctoritatem	auctoritas
contestantes	contestor
maiorem	magnus
congressum	congredior
retractatibus	retractatus
paucis	paucus
manifeste	manifeste
distinctio	distinctio
trinitatis	trinitas
exponitur	expono
pronuntiat	pronuntio
spiritus	spiritus
pater	pater
pronuntiat	pronuntio
filius	filius
pronuntiat	pronuntio
patrem	pater
filio	filius
filium	filius
filium	filius
patre	pater
patrem	pater
spiritum	spiritus
pronuntiantur	pronuntio
unamquamque	unusquisque
personam	persona
proprietate	proprietas
constituunt	constituo
numerus	numerus
scandalizat	scandalizo
trinitatis	trinitas
connexae	connecto
unitate	unitas
simplici	simplex
interrogo	interrogo
unicus	unicus
singularis	singularis
pluraliter	pluraliter
loquitur	loquor
hominem	homo
imaginem	imago
similitudinem	similitudo
debuerit	debeo
hominem	homo
imaginem	imago
similitudinem	similitudo
utpote	utpote
unicus	unicus
singularis	singularis
sequentibus	sequor
adam	ada
tanquam	tamquam1
unus	unus
fallit	fallo
ludit	ludo
unus	unus
solus	solus
singularis	singularis
numerose	numerose
loqueretur	loquor
numquid	numquid
angelis	angelus
loquebatur	loquor
iudaei	Iudaei
interpretantur	interpretor
filium	filius
agnoscunt	agnosco
pater	pater
filius	filius
spiritus	spiritus
pluralem	multalis
praestans	praestans
pluraliter	pluraliter
loquebatur	loquor
adhaerebat	adhaereo
filius	filius
secunda	secundus1
persona	persona
sermo	sermo
tertia	tertius
spiritus	spiritus
sermone	sermo
pluraliter	pluraliter
pronuntiavit	pronuntio
hominem	homo
similem	similis
filio	filius
induturus	induo
hominem	homo
spiritu	spiritus
sanctificaturus	sanctifico
hominem	homo
ministris	minister1
arbitris	arbiter
unitate	unitas
trinitatis	trinitas
loquebatur	loquor
sequens	sequens
scriptura	scriptura
distinguit	distinguo
personas	persona
deus	deus
hominem	homo
imaginem	imago
dei	deus
unus	unus
imaginem	imago
filii	filius
homo	homo
certior	certus
verior	uerus
imaginem	imago
hominem	homo
limo	limus1
formari	formo
imago	imago
veri	uerum1
similitudo	similitudo
antecedentibus	antecedo1
operibus	opus1
mundi	mundus1
scriptum	scribo
filio	filius
apparente	appareo
deus	deus
lux	lux
sermo	sermo
lux	lux
vera	uerus
illuminat	illumino
hominem	homo
venientem	uenio
mundum	mundus1
mundialis	mundialis
lux	lux
exinde	exinde
sermone	sermo
christo	christus
assistente	assisto
amministrante	amministro
deus	deus
voluit	uolo3
deus	deus
deus	deus
firmamentum	firmamentum
deus	deus
firmamentum	firmamentum
deus	deus
luminaria	luminare
deus	deus
luminare	lumino
maius	magnus
priora	prior
sermo	sermo
dei	deus
deus	deus
ioannem	Ioannes
deus	deus
sermo	sermo
duos	duo
accipere	accipio
debeas	debeo
professus	profiteor
personae	persona
substantiae	substantia
nomine	nomen
distinctionem	distinctio
divisionem	diuisio
ubique	ubique
teneam	teneo
unam	unus
substantiam	substantia
tribus	tres
cohaerentibus	cohaereo
oportet	oportet
necessitate	necessitas
sensus	sensus
iubet	iubeo
iuberet	iubeo
iuberet	iubeo
iubebat	iubeo
iussurus	iubeo
unus	unus
iussu	iussus
expectasset	exspecto
iuberet	iubeo
deus	deus
deus	deus
deus	deus
duo	duo
dii	deus
praedicantur	praedico1
durus	durus
puta	puto
amplius	ample
putes	puto
accipe	accipio
psalmo	psalmus
duos	duo
deos	deus
thronus	thronus
deus	deus
aevum	aeuum
virga	uirga
regni	regnum
dilexisti	diligo3
iustitiam	iustitia
odisti	odi
iniquitatem	iniquitas
propterea	propterea
unxit	ungo
deus	deus
deus	deus
deum	deus
loquitur	loquor
unctum	ungo
deum	deus
deo	deus
affirmat	affirmo
affirmasset	affirmo
duos	duo
deos	deus
virgae	uirga
regnatu	regnatus
esai	esa
personam	persona
christi	christus
seboin	seboeo
viri	uir
elati	effero?
transibunt	transeo1
sequentur	sequor
vincti	uincio
manibus	manus1
adorabunt	adoro
deus	deus
deus	deus
nesciebamus	nescio
deus	deus
israelis	israel
deus	deus
deus	deus
duos	duo
proponit	propono
christo	christus
spiritum	spiritus
sanctum	sanctus
evangelio	euangelium
totidem	totidem1
invenies	inuenio
principio	principium
sermo	sermo
sermo	sermo
deum	deus
dous	dous
sermo	sermo
unus	unus
nomen	nomen
domini	dominus
duobus	duo
lego	lego2
dominus	dominus
domino	dominus
sede	sedes
dexteram	dextera
eaias	eaius
domine	dominus
credidit	credo
auditui	auditus
brachium	brachium
domini	dominus
revelatum	reuelo
brachium	brachium
dominum	dominus
patrem	pater
dominum	dominus
filium	filius
intellegi	intelligo
vellet	uolo3
antiquior	antiquus
genesis	genesis
pluit	pluo
dominus	dominus
sodomam	sodoma
gomorram	gomorro
sulphur	sulfur
ignem	ignis
caele	caeles1
domino	dominus
nega	nego
scripta	scribo
putes	puto
accipienda	accipio
scripta	scribo
maxime	magis2
allegoriis	allegorius
parabolis	parabola
definitionibus	definitio
certis	certus
simplicibus	simplex
sensum	sensus
quodsi	quodsum
dominum	dominus
sustinebant	sustineo
dei	deus
filium	filius
ostendentem	ostendo
dominum	dominus
crederent	credo
recordare	recordor
scriptum	scribo
dii	deus
filii	filius
altissimi	altus
stetit	sto
deus	deus
ecclesia	ecclesia
deorum	deus
homines	homo
fidem	fides2
filios	filius
dei	deus
deos	deus
scriptura	scriptura
pronuntiare	pronuntio
timuit	timeo
scias	scio
unico	unicus
dei	deus
filio	filius
domini	dominus
nomen	nomen
iure	ius1
contulisse	confero
provocabo	prouoco
auctoritate	auctoritas
sripturarum	sriptura
constanter	constanter
duos	duo
deos	deus
duos	duo
dominos	dominus
praedices	praedico1
absit	absum1
tempora	tempus1
causas	causa
scripturarum	scriptura
dei	deus
gratiam	gratia
inspicimus	inspicio
maxime	magis2
paracleti	paracletus
hominum	homo
discipuli	discipulus
duos	duo
definimus	definio
patrem	pater
filium	filius
tres	tres
spiritu	spiritus
sancto	sanctus
rationem	ratio
oeconomiae	oeconomia
numerum	numerus
perversitas	peruersitas
infert	infero
pater	pater
credatur	credo
natus	nascor
passus	patior
credi	credo
traditum	trado
duos	duo
deos	deus
duos	duo
dominos	dominus
nunquam	numquam
ore	os1
proferimus	profero
pater	pater
deus	deus
filius	filius
deus	deus
spiritus	spiritus
sanctus	sanctus
deus	deus
deus	deus
unusquisque	unusquisque
retro	retro1
duo	duo
dii	deus
duo	duo
domini	dominus
praedicabantur	praedico1
venisset	uenio
christus	christus
deus	deus
agnosceretur	agnosco
dominus	dominus
vocaretur	uoco
filius	filius
dei	deus
domini	dominus
una	unus
persona	persona
dei	deus
domini	dominus
scripturis	scriptura
inveniretur	inuenio
merito	merito2
christus	christus
admissus	admitto
nomen	nomen
dei	deus
domini	dominus
unus	unus
deus	deus
unus	unus
dominus	dominus
praedicabatur	praedico1
pater	pater
descendisse	descendo
unus	unus
deus	deus
unus	unus
dominus	dominus
legebatur	lego2
tota	totus
oeconomia	oeconomia
obumbraretur	obumbro
materiam	materia
fidei	fides2
prospecta	prospectus
dispensata	dispenso
venit	uenio
christus	christus
cognitus	cognosco
numerum	numerus
retro	retro1
secundus	secundus2
patre	pater
spiritu	spiritus
tertius	tertius
pater	pater
plenius	plene
manifestatus	manifesto2
redactum	redigo
nomen	nomen
dei	deus
domini	dominus
unionem	unio1
nationes	natio1
multitudine	multitudo
idolorum	idolum
transirent	transeo1
unicum	unicus
deum	deus
differentia	differentia
constitueretur	constituo
cultores	cultor
unius	unus
divinitatis	diuinitas
lucere	luceo
mundo	mundus1
christianos	christianus1
oportebat	oportet
filios	filius
lucis	lux
lumen	lumen
mundi	mundus1
unum	unus
deum	deus
dominum	dominus
colentes	colo2
nominantes	nomino
conscientia	conscientia
scimus	scio
dei	deus
nomen	nomen
domini	dominus
patri	pater
filio	filius
spiritui	spiritus
convenire	conuenio
deos	deus
dominos	dominus
nominaremus	nomino
extinxissemus	exstinguo
faces	fax
martyria	martyrium
timidiores	timidus
evadendi	euado2
pateret	pateo
occasio	occasio
iurantibus	iuro
deos	deus
dominos	dominus
haeretici	haereticus
dei	deus
deos	deus
dominos	dominus
apostolum	apostolus
sequar	sequor
nominandi	nomino
pater	pater
filius	filius
deum	deus
patrem	pater
appellem	appello1
iesum	Iesus
christum	christus
dominum	dominus
nominem	nomino
christum	christus
deum	deus
apostolus	apostolus
christus	christus
deus	deus
benedictus	benedico2
aevum	aeuum
omen	omen
radium	radius
solis	sol
seorsum	seorsum1
solem	sol
vocabo	uoco
solem	sol
nominans	nomino
radius	radius
radium	radius
solem	sol
appellabo	appello1
soles	sol
duos	duo
solem	sol
radium	radius
duas	duo
duas	duo
species	species
unius	unus
indivisae	indiuisus
substantiae	substantia
numerabo	numero1
deum	deus
sermonem	sermo
patrem	pater
filium	filius
regula	regula
adsistit	assisto
duos	duo
vindicantibus	uindico
patrem	pater
filium	filius
invisibilem	inuisibilis
deum	deus
determinavit	determino
moyses	moyses
aegypto	aegyptum
desiderasset	desidero
domini	dominus
conspectum	conspectus1
inveni	inuenio
gratiam	gratia
manifesta	manifestus
cognoscenter	cognosco
faciem	facies
homo	homo
faciem	facies
vivet	uiuo
morietur	morior
invenimus	inuenio
deum	deus
mortuum	mortuus2
deum	deus
hominum	homo
capacitates	capacitas
plenitudinem	plenitudo
divinitatis	diuinitas
patriarchae	patriarcha
deum	deus
referuntur	refero
abraham	abraho
iacob	iacob
prophetae	propheta
esaias	Esaias
ezechiel	ezechiel
mortui	mortuus2
mori	morior
debuerant	debeo
deum	deus
vivet	uiuo
deum	deus
mortui	mortuus?
scriptura	scriptura
mentitur	mentior
deum	deus
faciem	facies
homo	homo
vivet	uiuo
scriptura	scriptura
mentitur	mentior
invisum	inuisus1
deum	deus
profert	profero
invisibilis	inuisibilis
definiri	definio
consequens	consequens2
invisibilem	inuisibilis
patrem	pater
intellegamus	intelligo
plenitudine	plenitudo
maiestatis	maiestas
visibilem	uisibilis
filium	filius
agnoscamus	agnosco
modulo	modulus
derivationis	deriuatio
sicutnec	sicut
{sicutnec}	ne2
solem	sol
contemplari	contemplor
substantiae	substantia
summam	superus
caelis	caelum1
radium	radius
toleramus	tolero
oculis	oculus
temperatura	temperatura
portionis	portio
terram	terra
porrigitur	porrigo2
diverso	diuersus
volet	uolo3
filium	filius
invisibilem	inuisibilis
contendere	contendo
sermonem	sermo
spiritum	spiritus
unam	unus
condicionem	condicio
patris	pater
filii	filius
vindicat	uindico
unum	unus
confirmae	confirmo
patrem	pater
filium	filius
scripturam	scriptura
differentiae	differentia
patrocinari	patrocinor
visibilis	uisibilis
invisibilis	inuisibilis
distinctionem	distinctio
adiciunt	adicio
argumentationem	argumentatio
filius	filius
moysen	moysen
loquebatur	loquor
faciem	facies
visibilem	uisibilis
pronuntiaret	pronuntio
invisibilis	inuisibilis
pater	pater
filii	filius
nomine	nomen
volunt	uolo3
accipi	accipio
visibilem	uisibilis
invisibilem	inuisibilis
patrem	pater
filium	filius
paulo	paulo
faciem	facies
moysi	moysis
negasset	nego
scriptum	scribo
dominum	dominus
moysen	moysen
locutum	loquor
loquatur	loquor
amicum	amicus1
iacob	iacob
dominum	dominus
facie	facies
faciem	facies
visibilis	uisibilis
invisibilis	inuisibilis
pater	pater
invisibilis	inuisibilis
filius	filius
visibilis	uisibilis
expositio	expositio
scripturae	scriptura
filio	filius
competat	competo
patre	pater
seposito	sepono
invisibilitate	inuisibilitas
filium	filius
nomine	nomen
eatenus	eatenus
invisibilem	inuisibilis
sermo	sermo
spiritus	spiritus
dei	deus
substantiae	substantia
condicione	condicio
deus	deus
sermo	sermo
spiritus	spiritus
dei	deus
visibilem	uisibilis
carnem	caro1
aaron	aaron
mariam	maria
prophetes	propheta
visione	uisio
cognocar	cognosco
somnio	somnium
loquar	loquor
moysi	moysis
os	os1
os	os1
loquar	loquor
specie	species
veritate	ueritas
aenigmate	aenigma
imagine	imago
apostolus	apostolus
tanquam	tamquam1
speculum	speculum
aenigmate	aenigma
facie	facies
faciem	facies
moysi	moysis
servat	seruo
conspectum	conspectus1
colloquium	colloquium
facie	facies
faciem	facies
adimpletum	adimpleo
montis	mons
secessu	secessus
legimus	lego2
evangelio	euangelium
moysen	moysen
colloquentem	colloquor
apparet	appareo
retro	retro1
speculo	speculum
aenigmate	aenigma
visione	uisio
somnio	somnium
deum	deus
filium	filius
dei	deus
prophetis	propheta
patriarchis	patriarcha
moysi	moysis
dominus	dominus
faciem	facies
loquebatur	loquor
homo	homo
faciem	facies
speculo	speculum
aenigmate	aenigma
moysi	moysis
locutus	loquor
dominus	dominus
moyses	moyses
faciem	facies
cominus	cominus
sciret	scio
ibidem	ibidem
desiderat	desidero
faciem	facies
desideraret	desidero
aeque	aeque
dominus	dominus
negat	nego
faciem	facies
ostenderat	ostendo
ostenderat	ostendo
dei	deus
conspectus	conspectus1
negatur	nego
iacob	iacob
deum	deus
facie	facies
faciem	facies
salva	saluus
anima	anima
debet	debeo
occidit	occido2
numquid	numquid
filius	filius
visione	uisio
somnio	somnium
speculo	speculum
aenigmate	aenigma
sermo	sermo
spiritus	spiritus
imaginaria	imaginarius
forma	forma
faciem	facies
invisibilem	inuisibilis
patrem	pater
pater	pater
filii	filius
nomine	nomen
auctoritatis	auctoritas
genitus	gigno
patre	pater
consequitur	consequor
maiore	magnus
persona	persona
congruit	congruo
homo	homo
faciem	facies
praestat	praesto1
pater	pater
maior	magnus
filii	filius
pater	pater
scriptura	scriptura
spiritus	spiritus
personae	persona
christus	christus
dominus	dominus
christus	christus
personae	persona
paternae	paternus
spiritus	spiritus
merito	merito2
spiritus	spiritus
personae	persona
patris	pater
faciem	facies
unitate	unitas
pronuntiavit	pronuntio
mira	mirus
filii	filius
pater	pater
accipi	accipio
caput	caput
caput	caput
christi	christus
deus	deus
articulum	articulus
quaestionibus	quaestio
scripturae	scriptura
veteris	uetus
expediam	expedio
novo	nouus
testamento	testamentum
sumam	sumo
confirmationem	confirmatio
interpretationis	interpretatio
filium	filius
reputo	reputo
patrem	pater
defendas	defendo
evangeliis	euangelium
apostolis	apostolus
visibilem	uisibilis
invisibilem	inuisibilis
deum	deus
deprehendo	deprehendo
manifesta	manifestus
personali	personalis
distinctione	distinctio
condicionis	condicio
utriusque	uterque
exclamat	exclamo
ioannes	Ioannes
deum	deus
unquam	umquam
retro	retro1
ademit	adimo
temporis	tempus1
quaestionem	quaestio
deum	deus
nunquam	numquam
confirmat	confirmo
apostolus	apostolus
deo	deus
hominum	homo
morietur	morior
apostoli	apostolus
christum	christus
contrectasse	contrecto
testantur	testor
porro	porro
christus	christus
pater	pater
filius	filius
invisus	inuisus1
diversitatem	diuersitas
invisi	inuisus1
unum	unus
conferendam	confero
diverso	diuersus
argumentabitur	argumentor
recte	recte
visibilem	uisibilis
carne	caro1
invisibilem	inuisibilis
carnem	caro1
pater	pater
invisibilis	inuisibilis
carnem	caro1
filius	filius
visibilis	uisibilis
carne	caro1
atquin	atqui
carnem	caro1
invisibilis	inuisibilis
retro	retro1
invenitur	inuenio
carnem	caro1
aeque	aeque
carnem	caro1
visibilis	uisibilis
invisibilis	inuisibilis
pronuntiatur	pronuntio
apostolis	apostolus
retro	retro1
aenigmate	aenigma
plenius	plene
visibilem	uisibilis
caro	caro1
effecit	efficio
sermo	sermo
caro	caro1
nunquam	numquam
pater	pater
sermo	sermo
inspiciamus	inspicio
apostoli	apostolus
ioannes	Ioannes
audivimus	audio
oculis	oculus
manus	manus1
contrectaverunt	contrecto
sermone	sermo
vitae	uita
sermo	sermo
vitae	uita
caro	caro1
auditus	auditus
contrectatus	contrecto
caro	caro1
carnem	caro1
sermo	sermo
primordio	primordium
deum	deus
patrem	pater
pater	pater
sermonem	sermo
deus	deus
sermo	sermo
deum	deus
deo	deus
deus	deus
patre	pater
patrem	pater
gloriam	gloria
tanquam	tamquam1
unigeniti	unigenitus
patre	pater
filii	filius
visibilis	uisibilis
glorificati	glorifico
patre	pater
invisibili	inuisibilis
sermonem	sermo
dei	deus
deum	deus
adiuvaret	adiuuo
adversariorum	aduersarius1
praesumptionem	praesumptio
patrem	pater
distinguendum	distinguo
invisibilem	inuisibilis
patrem	pater
filium	filius
visibilem	uisibilis
superdicit	superdico
abundanti	abundans2
deum	deus
unquam	umquam
deum	deus
sermonem	sermo
atquin	atqui
audivimus	audio
contrectavimus	contrecto
sermone	sermo
vitae	uita
praedictum	praedico2
deum	deus
patrem	pater
deum	deus
sermo	sermo
unigenitus	unigenitus
filius	filius
sinu	sinus
patris	pater
disseruit	dissero2
auditus	auditus
phantasma	phantasma
crederetur	credo
contrectatus	contrecto
paulus	paulus
conspexit	conspicio
patrem	pater
iesum	Iesus
christum	christus
deum	deus
cognominavit	cognomino
patres	pater
christus	christus
carnem	caro1
deus	deus
benedictus	benedico2
aevum	aeuum
ostendit	ostendo
visibilem	uisibilis
dei	deus
filium	filius
sermonem	sermo
dei	deus
caro	caro1
christus	christus
patre	pater
timotheum	timotheus
hominum	homo
exaggerans	exaggero1
amplius	ample
solus	solus
immortalitatem	immortalitas
lucem	lux
habitat	habito
inaccessibilem	inaccessibilis
regi	rex
saeculorum	saeculum
immortali	immortalis
invisibili	inuisibilis
soli	solus
deo	deus
contraria	contrarius
filio	filius
adscriberemus	ascribo
mortalitatem	mortalitas
accessibilitatem	accessibilitas
mortuum	mortuus?
contestatur	contestor
scripturas	scriptura
novissime	noue
accessibilem	accessibilis
lucem	lux
periculo	periculum
luminis	lumen
expertus	experior
aenigmate	aenigma
plenius	plene
visibilem	uisibilis
caro	caro1
elã	ela
­	­
ecit	ecio
sermo	sermo
caro	caro1
nunquam	numquam
nis	ni2
pater	pater
sermo	sermo
inspiciamus	inspicio
apostoli	apostolus
viderã	uideo
­	­
nt	tribunus
ioannes	Ioannes
audivimus	audio
oculis	oculus
manus	manus1
contrectaverunt	contrecto
sermone	sermo
vitae	uita
sermo	sermo
vitae	uita
caro	caro1
auditus	auditus
contrectatus	contrecto
caro	caro1
carnem	caro1
sermo	sermo
primordio	primordium
deum	deus
patrem	pater
pater	pater
sermonem	sermo
deus	deus
sermo	sermo
deum	deus
deo	deus
deus	deus
pã	pabeo
¢	¢
tre	tres
patrem	pater
gloriam	gloria
tanquam	tamquam1
unigeniti	unigenitus
patre	pater
filii	filius
visibilis	uisibilis
glorificati	glorifico
patre	pater
invisibili	inuisibilis
sermonem	sermo
dei	deus
deum	deus
adiuvaret	adiuuo
adversariorum	aduersarius1
praesumptionem	praesumptio
patrem	pater
distinguendum	distinguo
invisibilem	inuisibilis
patrem	pater
filium	filius
visibilem	uisibilis
superdicit	superdico
abundanti	abundans2
deum	deus
unquam	umquam
deum	deus
sermonem	sermo
atquin	atqui
